a	mot
able	the
about	ve
above	tren day
act	hanh dong
add	them
afraid	so
after	sau khi
again	mot lan nua
against	chong lai
age	tuoi
ago	truoc
agree	dong y
air	khong khi
all	tat ca
allow	cho phep
also	cung
always	luon luon
am	la
among	trong
an	mot
and	va
anger	tuc gian
animal	dong vat
answer	cau tra loi
any	bat ky
appear	xuat hien
apple	tao
are	la
area	khu vuc
arm	canh tay
arrange	sap xep
arrive	den
art	nghe thuat
as	nhu
ask	xin
at	tai
atom	nguyen tu
baby	be
back	tro lai
bad	xau
ball	bong
band	ban nhac
bank	ngan hang
bar	thanh
base	co so
basic	co ban
bat	bat
be	duoc
bear	chiu
beat	danh bai
beauty	ve dep
bed	giuong
been	duoc
before	truoc
began	bat dau
begin	bat dau
behind	sau
believe	tin
bell	chuong
best	tot nhat
better	tot hon
between	giua
big	lon
bird	chim
bit	bit
black	den
block	khoi
blood	mau
blow	don
blue	mau xanh
board	hoi dong quan tri
boat	thuyen
body	co the
bone	xuong
book	cuon sach
born	sinh
both	ca hai
bottom	duoi
bought	mua
box	hop
boy	cau be
branch	chi nhanh
bread	banh mi
break	nghi
bright	sang
bring	mang lai
broad	rong
broke	da pha vo
brother	anh trai
brought	mang
brown	nau
build	xay dung
burn	ghi
busy	ban ron
but	nhung
buy	mua
by	boi
call	goi
came	den
camp	trai
can	co the
capital	von
captain	doi truong
car	xe
card	the
care	cham soc
carry	thuc hien
case	khi
cat	meo
catch	bat
caught	bat
cause	nguyen nhan
cell	pin
cent	phan tram
center	trung tam
century	the ky
certain	nhat dinh
chair	ghe
chance	co hoi
change	thay doi
character	nhan vat
charge	phi
chart	bieu do
check	kiem tra
chick	ga
chief	truong
child	con
children	tre em
choose	chon
chord	hop am
circle	vong tron
city	thanh pho
claim	xin
class	lop
clean	sach
clear	trong
climb	len cao
clock	dong ho
close	gan
clothe	mac
cloud	dien toan dam may
coast	bo bien
coat	ao
cold	lanh
collect	thu thap
colony	thuoc dia
color	mau
column	cot
come	den
common	pho bien
company	cong ty
compare	so sanh
complete	hoan thanh
condition	dieu kien
connect	ket noi
consider	xem xet
consonant	phu am
contain	chua
continent	luc
continue	tiep tuc
control	kiem soat
cook	nau an
cool	mat me
copy	ban sao
corn	ngo
corner	goc
correct	chinh xac
cost	chi phi
cotton	bong
could	co the
count	tinh
country	nuoc
course	tat nhien
cover	bia
cow	bo
crease	nep
create	tao
crop	cay trong
cross	qua
crowd	dam dong
cry	keu
current	hien tai
cut	cat
dad	cha
dance	khieu vu
danger	nguy hiem
dark	toi
day	ngay
dead	chet
deal	thoa thuan
dear	than yeu
death	chet
decide	quyet dinh
decimal	so thap phan
deep	sau
degree	muc do
depend	phu thuoc
describe	mo ta
desert	sa mac
design	thiet ke
determine	xac dinh
develop	phat trien
dictionary	tu dien
did	da lam
die	chet
differ	khac nhau
difficult	kho khan
direct	truc tiep
discuss	thao luan
distant	xa
divide	chia
division	phan chia
do	lam
doctor	bac si
does	khong
dog	con cho
dollar	dong dola
dont	khong
done	xong
door	cua
double	doi
down	xuong
draw	ve
dream	mo
dress	vay
drink	ly
drive	lai
drop	roi
dry	kho
duck	vit
during	trong khi
each	moi
ear	tai
early	dau
earth	dat
ease	giam bot
east	dong
eat	an
edge	canh
effect	hieu luc
egg	trung
eight	tam
either	hoac
electric	dien
element	yeu to
else	khac
end	cuoi
enemy	ke thu
energy	nang luong
engine	dong co
enough	du
enter	nhap
equal	nhu nhau
equate	danh dong
especially	dac biet la
even	tham chi
evening	buoi toi
event	su kien
ever	bao gio
every	moi
exact	chinh xac
example	vi du
except	tru
excite	kich thich
exercise	tap the duc
expect	mong doi
experience	kinh nghiem
experiment	thi nghiem
eye	mat
face	khuon mat
fact	thuc te
fair	cong bang
fall	giam
family	gia dinh
famous	noi tieng
far	xa
farm	trang trai
fast	nhanh chong
fat	chat beo
father	cha
favor	ung ho
fear	so hai
feed	thu can chan nuoi
feel	cam thay
feet	chan
fell	giam
felt	cam thay
few	so
field	linh vuc
fig	sung
fight	cuoc chien
figure	con so
fill	dien
final	cuoi cung
find	tim
fine	tot
finger	ngon tay
finish	ket thuc
fire	lua
first	dau tien
fish	ca
fit	phu hop voi
five	nam
flat	phang
floor	san
flow	chay
flower	hoa
fly	bay
follow	theo
food	thuc pham
foot	chan
for	cho
force	luc
forest	rung
form	hinh thuc
forward	ve phia truoc
found	tim thay
four	bon
fraction	phan
free	mien phi
fresh	tuoi
friend	nguoi ban
from	tu
front	truoc
fruit	trai cay
full	day du
fun	vui ve
game	tro choi
garden	vuon
gas	khi
gather	thu thap
gave	dua
general	chung
gentle	nhe nhang
get	duoc
girl	co gai
give	cung cap cho
glad	vui
glass	kinh
go	di
gold	vang
gone	ra di
good	tot
got	co
govern	phoi
grand	lon
grass	co
gray	mau xam
great	tuyet voi
green	mau xanh la cay
grew	tang
ground	mat dat
group	nhom
grow	phat trien
guess	doan
guide	huong dan
gun	sung
had	co
hair	long
half	mot nua
hand	tay
happen	xay ra
happy	hanh phuc
hard	cung
has	co
hat	mu
have	co
he	ong
head	dau
hear	nghe
heard	nghe
heart	tim
heat	nhiet
heavy	nang
held	duoc to chuc
help	giup
her	co
here	o day
high	cao
hill	doi
him	anh
his	minh
history	lich su
hit	nhan
hold	giu
hole	lo
home	nha
hope	hy vong
horse	ngua
hot	nong
hot	nong
hour	gio
house	nha
how	nhu the nao
huge	to
human	con nguoi
hundred	tram
hunt	san
hurry	nhanh
ice	bang
idea	y tuong
if	neu
imagine	tuong tuong
in	trong
inch	inch
include	bao gom
indicate	chi ra
industry	nganh cong nghiep
insect	con trung
instant	ngay lap tuc
interest	quan tam
invent	phat minh
iron	sat
is	la
island	dao
it	no
job	cong viec
join	tham gia
joy	niem vui
jump	nhay
just	chi
keep	giu
kept	giu
key	chinh
kill	giet
kind	loai
king	vua
knew	biet
know	biet
lady	phu nu
lake	ho
land	dat
language	ngon ngu
large	lon
last	cuoi cung
late	cuoi
laugh	cuoi
law	phap luat
lay	dat
lead	dan
learn	hoc
least	nhat
leave	lai
led	dan
left	con lai
leg	chan
length	chieu dai
less	it
let	cho phep
letter	thu
level	muc
lie	loi noi doi
life	cuoc song
lift	thang may
light	anh sang
like	nhu
line	dong
liquid	chat long
list	danh sach
listen	lang nghe
little	it
live	song
locate	xac dinh vi tri
log	dang nhap
lone	don doc
long	lau
look	xem
lost	thua
lot	rat nhieu
loud	lon
love	tinh yeu
low	thap
machine	may
made	thuc hien
magnet	nam cham
main	chinh
major	chinh
make	lam
man	nguoi dan ong
many	nhieu
map	ban do
mark	danh dau
market	thi truong
mass	khoi luong
master	chu
match	tran dau
material	tai lieu
matter	van de
may	co the
me	toi
mean	co nghia la
meant	co nghia la
measure	do luong
meat	thit
meet	dap ung
melody	giai dieu
men	nguoi dan ong
metal	kim loai
method	phuong phap
middle	trung
mile	dam
milk	sua
million	trieu
mind	tam
mine	toi
minute	phut
miss	bo lo
mix	tron
modern	hien dai
molecule	phan tu
moment	thoi diem
money	tien
month	thang
moon	mat trang
more	hon
morning	buoi sang
most	nhat
mother	me
motion	chuyen dong
mountain	nui
mouth	mieng
move	di chuyen
much	nhieu
multiply	nhan
music	nhac
must	phai
my	cua toi
name	ten
nation	quoc gia
natural	tu nhien
nature	thien nhien
near	gan
necessary	can thiet
neck	co
need	can
neighbor	hang xom
never	khong bao gio
new	moi
next	tiep theo
night	dem
nine	chin
no	khong co
noise	tieng on
noon	trua
nor	cung khong
north	phia bac
nose	mui
note	ghi
nothing	khong co gi
notice	thong bao
noun	danh tu
now	bay gio
number	so
numeral	chu so
object	doi tuong
observe	quan sat
occur	xay ra
ocean	dai duong
of	cua
off	tat
offer	phuc vu
office	van phong
often	thuong
oil	dau
old	cu
on	tren
once	mot lan
one	mot
only	chi
open	mo
operate	hoat dong
opposite	nguoc lai
or	hoac
order	de
organ	co quan
original	ban dau
other	khac
our	cua chung toi
out	ra
over	hon
own	rieng
oxygen	oxy
page	trang
paint	son
pair	doi
paper	giay
paragraph	doan
parent	bo me
part	mot phan
particular	rieng
party	buoi tiec
pass	vuot qua
past	qua
path	con duong
pattern	mo hinh
pay	tra
people	nhan dan
perhaps	co le
period	thoi gian
person	nguoi
phrase	cum tu
pick	chon
picture	hinh anh
piece	manh
pitch	san
place	noi
plain	dong bang
plan	ke hoach
plane	may bay
planet	hanh tinh
plant	nha may
play	choi
please	xin vui long
plural	so nhieu
poem	bai tho
point	diem
poor	nguoi ngheo
port	cong
pose	da tra
position	vi tri
possible	co the
post	bai
pound	bang
power	dien
practice	thuc hanh
prepare	chuan bi
present	hien nay
press	bao chi
pretty	kha
print	in
probable	co the xay ra
problem	van de
process	qua trinh
produce	san xuat
product	san pham
proper	thich hop
property	tai san
protect	bao ve
prove	chung minh
provide	cho
pull	keo
push	day
put	dat
quart	lit
question	cau hoi
quick	nhanh chong
quiet	yen tinh
quite	kha
quotient	thuong
race	cuoc dua
radio	radio
rail	duong sat
rain	mua
raise	nang cao
ran	ran
range	pham vi
rather	thay
reach	dat
read	doc
ready	san sang
real	thuc
reason	ly do
receive	nhan
record	ghi
red	mau do
region	khu
remember	nho
repeat	lap lai
reply	tra loi
represent	dai dien
require	yeu cau
rest	phan con lai
result	ket qua
rich	giau
ride	di xe
right	ngay
ring	vong
rise	tang
river	song
road	duong
rock	da
roll	cuon
room	phong
root	goc
rope	day
rose	tang
round	chung quanh
row	hang
rub	cha
rule	quy tac
run	chay
safe	an toan
said	noi
sail	buom
salt	muoi
same	nhu nhau
sand	cat
sat	ngoi
save	luu
saw	cua
say	noi
scale	quy mo
school	truong
science	khoa hoc
score	diem
sea	bien
search	tim kiem
season	mua
seat	ghe
second	thu hai
section	phan
see	thay
seed	hat giong
seem	duong nhu
segment	phan khuc
select	chon
self	tu
sell	ban
send	gui
sense	y nghia
sent	gui
sentence	cau
separate	rieng biet
serve	phuc vu
set	bo
settle	giai quyet
seven	bay
several	nhieu
shall	co trach nhiem
shape	hinh dang
share	chia se
sharp	sac net
she	co
sheet	to
shell	vo
shine	toa sang
ship	tau
shoe	giay
shop	cua hang
short	ngan
should	nen
shoulder	vai
shout	het len
show	chuong trinh
side	ben
sight	canh
sign	dau hieu
silent	im lang
silver	bac
similar	tuong tu
simple	don gian
since	tu
sing	hat
single	don
sister	em gai
sit	ngoi
six	sau
size	kich thuoc
skill	ky nang
skin	da
sky	bau troi
slave	no le
sleep	ngu
slip	truot
slow	cham
small	nho
smell	mui
smile	nu cuoi
snow	tuyet
so	de
soft	mem
soil	dat
soldier	nguoi linh
solution	giai phap
solve	giai quyet
some	mot so
son	con trai
song	bai hat
soon	som
sound	am thanh
south	nam
space	khong gian
speak	noi
special	dac biet
speech	bai phat bieu
speed	toc do
spell	chinh ta
spend	chi tieu
spoke	noi
spot	tai cho
spread	lay lan
spring	mua xuan
square	vuong
stand	dung
star	sao
start	bat dau
state	nha nuoc
station	tram
stay	o lai
stead	thay
steam	hoi nuoc
steel	thep
step	buoc
stick	thanh
still	van
stone	da
stood	dung
stop	ngan chan
store	cua hang
story	cau chuyen
straight	thang
strange	la
stream	song
street	duong pho
stretch	cang ra
string	chuoi
strong	manh me
student	sinh vien
study	nghien cuu
subject	tieu de
substance	chat
subtract	tru
success	thanh cong
such	nhu vay
sudden	dot ngot
suffix	hau to
sugar	duong
suggest	de nghi
suit	phu hop voi
summer	mua he
sun	mat troi
supply	cung cap
support	ho tro
sure	chac chan
surface	be mat
surprise	bat ngo
swim	boi
syllable	am tiet
symbol	bieu tuong
system	he thong
table	bang
tail	duoi
take	co
talk	noi chuyen
tall	cao
teach	day
team	doi
teeth	rang
tell	noi
temperature	nhiet do
ten	muoi
term	han
test	kiem tra
than	hon
thank	cam on
that	ma
the	cac
their	cua ho
them	ho
then	sau do
there	co
these	cac
they	ho
thick	day
thin	mong
thing	dieu
think	nghi
third	thu ba
this	nay
those	nhung
though	mac du
thought	nghi
thousand	ngan
three	ba
through	thong qua
throw	nem
thus	do do
tie	ca vat
time	thoi gian
tiny	nho
tire	lop xe
to	de
together	cung
told	noi
tone	giai dieu
too	qua
took	mat
tool	cong cu
top	dau
total	tong so
touch	cham
toward	huong
town	thi tran
track	theo doi
trade	thuong mai
train	dao tao
travel	du lich
tree	cay
triangle	tam giac
trip	chuyen di
trouble	rac roi
truck	xe tai
true	dung
try	thu
tube	ong
turn	lan luot
twenty	hai muoi
two	hai
type	loai
under	duoi
unit	don vi
until	cho den khi
up	len
us	chung toi
use	su dung
usual	thong thuong
valley	thung lung
value	gia tri
vary	khac nhau
verb	dong tu
very	rat
view	xem
village	lang
visit	lan
voice	giong noi
vowel	nguyen am
wait	doi
walk	di bo
wall	tuong
want	muon
war	chien tranh
warm	am ap
was	la
wash	rua
watch	xem
water	nuoc
wave	song
way	cach
we	chung toi
wear	mac
weather	thoi tiet
week	tuan
weight	trong luong
well	cung
went	di
were	la
west	tay
what	nhung gi
wheel	banh xe
when	khi
where	noi
whether	lieu
which	ma
while	trong khi
white	trang
who	nguoi
whole	toan bo
whose	co
why	ly do tai sao
wide	rong
wife	vo
wild	hoang da
will	se
win	gianh chien thang
wind	gio
window	cua so
wing	canh
winter	mua dong
wire	day
wish	muon
with	voi
woman	nguoi phu nu
women	phu nu
won't	se khong
wonder	tu hoi
wood	go
word	tu
work	cong viec
world	the gioi
would	se
write	viet
written	bang van ban
wrong	sai
wrote	da viet
yard	san
year	nam
yellow	vang
yes	vang
yet	nhung
you	anh
young	tre
your	cua ban
