as	nhu
his	minh
that	ma
he	ong
was	la
for	cho
on	tren
are	la
with	voi
they	ho
be	duoc
at	tai
one	mot
have	co
this	nay
from	tu
by	boi
hot	nong
word	tu
but	nhung
what	nhung gi
some	mot so
is	la
it	no
you	anh
or	hoac
had	co
the	cac
of	cua
to	de
and	va
a	mot
in	trong
we	chung toi
can	co the
out	ra
other	khac
were	la
which	ma
do	lam
their	cua ho
time	thoi gian
if	neu
will	se
how	nhu the nao
said	noi
an	mot
each	moi
tell	noi
does	khong
set	bo
three	ba
want	muon
air	khong khi
well	cung
also	cung
play	choi
small	nho
end	cuoi
put	dat
home	nha
read	doc
hand	tay
port	cong
large	lon
spell	chinh ta
add	them
even	tham chi
land	dat
here	o day
must	phai
big	lon
high	cao
such	nhu vay
follow	theo
act	hanh dong
why	ly do tai sao
ask	xin
men	nguoi dan ong
change	thay doi
went	di
light	anh sang
kind	loai
off	tat
need	can
house	nha
picture	hinh anh
try	thu
us	chung toi
again	mot lan nua
animal	dong vat
point	diem
mother	me
world	the gioi
near	gan
build	xay dung
self	tu
earth	dat
father	cha
any	bat ky
new	moi
work	cong viec
part	mot phan
take	co
get	duoc
place	noi
made	thuc hien
live	song
where	noi
after	sau khi
back	tro lai
little	it
only	chi
round	chung quanh
man	nguoi dan ong
year	nam
came	den
show	chuong trinh
every	moi
good	tot
me	toi
give	cung cap cho
our	cua chung toi
under	duoi
name	ten
very	rat
through	thong qua
just	chi
form	hinh thuc
sentence	cau
great	tuyet voi
think	nghi
say	noi
help	giup
low	thap
line	dong
differ	khac nhau
turn	lan luot
cause	nguyen nhan
much	nhieu
mean	co nghia la
before	truoc
move	di chuyen
right	ngay
boy	cau be
old	cu
too	qua
same	nhu nhau
she	co
all	tat ca
there	co
when	khi
up	len
use	su dung
your	cua ban
way	cach
about	ve
many	nhieu
then	sau do
them	ho
write	viet
would	se
like	nhu
so	de
these	cac
her	co
long	lau
make	lam
thing	dieu
see	thay
him	anh
two	hai
has	co
look	xem
more	hon
day	ngay
could	co the
go	di
come	den
did	da lam
number	so
sound	am thanh
no	khong co
most	nhat
people	nhan dan
my	cua toi
over	hon
know	biet
water	nuoc
than	hon
call	goi
first	dau tien
who	nguoi
may	co the
down	xuong
side	ben
been	duoc
now	bay gio
find	tim
head	dau
stand	dung
own	rieng
page	trang
should	nen
country	nuoc
found	tim thay
answer	cau tra loi
school	truong
grow	phat trien
study	nghien cuu
still	van
learn	hoc
plant	nha may
cover	bia
food	thuc pham
sun	mat troi
four	bon
between	giua
state	nha nuoc
keep	giu
eye	mat
never	khong bao gio
last	cuoi cung
let	cho phep
thought	nghi
city	thanh pho
tree	cay
cross	qua
farm	trang trai
hard	cung
start	bat dau
story	cau chuyen
saw	cua
far	xa
sea	bien
draw	ve
left	con lai
late	cuoi
run	chay
dont	khong
while	trong khi
press	bao chi
close	gan
night	dem
real	thuc
life	cuoc song
few	so
north	phia bac
book	cuon sach
carry	thuc hien
took	mat
science	khoa hoc
eat	an
room	phong
friend	nguoi ban
began	bat dau
idea	y tuong
fish	ca
mountain	nui
stop	ngan chan
once	mot lan
base	co so
hear	nghe
horse	ngua
cut	cat
sure	chac chan
watch	xem
color	mau
face	khuon mat
wood	go
main	chinh
open	mo
seem	duong nhu
together	cung
next	tiep theo
white	trang
children	tre em
begin	bat dau
got	co
walk	di bo
example	vi du
ease	giam bot
paper	giay
group	nhom
always	luon luon
music	nhac
those	nhung
both	ca hai
mark	danh dau
often	thuong
letter	thu
until	cho den khi
mile	dam
river	song
car	xe
feet	chan
care	cham soc
second	thu hai
enough	du
plain	dong bang
girl	co gai
usual	thong thuong
young	tre
ready	san sang
above	tren day
ever	bao gio
red	mau do
list	danh sach
though	mac du
feel	cam thay
talk	noi chuyen
bird	chim
soon	som
body	co the
dog	con cho
family	gia dinh
direct	truc tiep
pose	da tra
leave	lai
song	bai hat
measure	do luong
door	cua
product	san pham
black	den
short	ngan
numeral	chu so
class	lop
wind	gio
question	cau hoi
happen	xay ra
complete	hoan thanh
ship	tau
area	khu vuc
half	mot nua
rock	da
order	de
fire	lua
south	nam
problem	van de
piece	manh
told	noi
knew	biet
pass	vuot qua
since	tu
top	dau
whole	toan bo
king	vua
street	duong pho
inch	inch
multiply	nhan
nothing	khong co gi
course	tat nhien
stay	o lai
wheel	banh xe
full	day du
force	luc
blue	mau xanh
object	doi tuong
decide	quyet dinh
surface	be mat
deep	sau
moon	mat trang
island	dao
foot	chan
system	he thong
busy	ban ron
test	kiem tra
record	ghi
boat	thuyen
common	pho bien
gold	vang
possible	co the
plane	may bay
stead	thay
dry	kho
wonder	tu hoi
laugh	cuoi
thousand	ngan
ago	truoc
ran	ran
check	kiem tra
game	tro choi
shape	hinh dang
equate	danh dong
hot	nong
miss	bo lo
brought	mang
heat	nhiet
snow	tuyet
tire	lop xe
bring	mang lai
yes	vang
distant	xa
fill	dien
east	dong
paint	son
language	ngon ngu
among	trong
unit	don vi
power	dien
town	thi tran
fine	tot
certain	nhat dinh
fly	bay
fall	giam
lead	dan
cry	keu
dark	toi
machine	may
note	ghi
wait	doi
plan	ke hoach
figure	con so
star	sao
box	hop
noun	danh tu
field	linh vuc
rest	phan con lai
correct	chinh xac
able	the
pound	bang
done	xong
beauty	ve dep
drive	lai
stood	dung
contain	chua
front	truoc
teach	day
week	tuan
final	cuoi cung
gave	dua
green	mau xanh la cay
quick	nhanh chong
develop	phat trien
ocean	dai duong
warm	am ap
free	mien phi
minute	phut
strong	manh me
special	dac biet
mind	tam
behind	sau
clear	trong
tail	duoi
produce	san xuat
fact	thuc te
space	khong gian
heard	nghe
best	tot nhat
hour	gio
better	tot hon
true	dung
during	trong khi
hundred	tram
five	nam
remember	nho
step	buoc
early	dau
hold	giu
west	tay
ground	mat dat
interest	quan tam
reach	dat
fast	nhanh chong
verb	dong tu
sing	hat
listen	lang nghe
six	sau
table	bang
travel	du lich
less	it
morning	buoi sang
ten	muoi
simple	don gian
several	nhieu
vowel	nguyen am
toward	huong
war	chien tranh
lay	dat
against	chong lai
pattern	mo hinh
slow	cham
center	trung tam
love	tinh yeu
person	nguoi
money	tien
serve	phuc vu
appear	xuat hien
road	duong
map	ban do
rain	mua
rule	quy tac
govern	phoi
pull	keo
cold	lanh
notice	thong bao
voice	giong noi
energy	nang luong
hunt	san
probable	co the xay ra
bed	giuong
brother	anh trai
egg	trung
ride	di xe
cell	pin
believe	tin
perhaps	co le
pick	chon
sudden	dot ngot
count	tinh
square	vuong
reason	ly do
length	chieu dai
represent	dai dien
art	nghe thuat
subject	tieu de
region	khu
size	kich thuoc
vary	khac nhau
settle	giai quyet
speak	noi
weight	trong luong
general	chung
ice	bang
matter	van de
circle	vong tron
pair	doi
include	bao gom
divide	chia
syllable	am tiet
felt	cam thay
grand	lon
ball	bong
yet	nhung
wave	song
drop	roi
heart	tim
am	la
present	hien nay
heavy	nang
dance	khieu vu
engine	dong co
position	vi tri
arm	canh tay
wide	rong
sail	buom
material	tai lieu
fraction	phan
forest	rung
sit	ngoi
race	cuoc dua
window	cua so
store	cua hang
summer	mua he
train	dao tao
sleep	ngu
prove	chung minh
lone	don doc
leg	chan
exercise	tap the duc
wall	tuong
catch	bat
wish	muon
sky	bau troi
board	hoi dong quan tri
joy	niem vui
winter	mua dong
sat	ngoi
written	bang van ban
wild	hoang da
kept	giu
glass	kinh
grass	co
cow	bo
job	cong viec
edge	canh
sign	dau hieu
visit	lan
past	qua
soft	mem
fun	vui ve
bright	sang
gas	khi
weather	thoi tiet
month	thang
million	trieu
bear	chiu
finish	ket thuc
happy	hanh phuc
hope	hy vong
flower	hoa
clothe	mac
strange	la
gone	ra di
trade	thuong mai
melody	giai dieu
trip	chuyen di
office	van phong
receive	nhan
row	hang
mouth	mieng
exact	chinh xac
symbol	bieu tuong
die	chet
least	nhat
trouble	rac roi
shout	het len
except	tru
wrote	da viet
seed	hat giong
tone	giai dieu
join	tham gia
suggest	de nghi
clean	sach
break	nghi
lady	phu nu
yard	san
rise	tang
bad	xau
blow	don
oil	dau
blood	mau
touch	cham
grew	tang
cent	phan tram
mix	tron
team	doi
wire	day
cost	chi phi
lost	thua
brown	nau
wear	mac
garden	vuon
equal	nhu nhau
sent	gui
choose	chon
fell	giam
fit	phu hop voi
flow	chay
fair	cong bang
bank	ngan hang
collect	thu thap
save	luu
control	kiem soat
decimal	so thap phan
ear	tai
else	khac
quite	kha
broke	da pha vo
case	khi
middle	trung
kill	giet
son	con trai
lake	ho
moment	thoi diem
scale	quy mo
loud	lon
spring	mua xuan
observe	quan sat
child	con
straight	thang
consonant	phu am
nation	quoc gia
dictionary	tu dien
milk	sua
speed	toc do
method	phuong phap
organ	co quan
pay	tra
age	tuoi
section	phan
dress	vay
cloud	dien toan dam may
surprise	bat ngo
quiet	yen tinh
stone	da
tiny	nho
climb	len cao
cool	mat me
design	thiet ke
poor	nguoi ngheo
lot	rat nhieu
experiment	thi nghiem
bottom	duoi
key	chinh
iron	sat
single	don
stick	thanh
flat	phang
twenty	hai muoi
skin	da
smile	nu cuoi
crease	nep
hole	lo
jump	nhay
baby	be
eight	tam
village	lang
meet	dap ung
root	goc
buy	mua
raise	nang cao
solve	giai quyet
metal	kim loai
whether	lieu
push	day
seven	bay
paragraph	doan
third	thu ba
shall	co trach nhiem
held	duoc to chuc
hair	long
describe	mo ta
cook	nau an
floor	san
either	hoac
result	ket qua
burn	ghi
hill	doi
safe	an toan
cat	meo
century	the ky
consider	xem xet
type	loai
law	phap luat
bit	bit
coast	bo bien
copy	ban sao
phrase	cum tu
silent	im lang
tall	cao
sand	cat
soil	dat
roll	cuon
temperature	nhiet do
finger	ngon tay
industry	nganh cong nghiep
value	gia tri
fight	cuoc chien
lie	loi noi doi
beat	danh bai
excite	kich thich
natural	tu nhien
view	xem
sense	y nghia
capital	von
won't	se khong
chair	ghe
danger	nguy hiem
fruit	trai cay
rich	giau
thick	day
soldier	nguoi linh
process	qua trinh
operate	hoat dong
practice	thuc hanh
separate	rieng biet
difficult	kho khan
doctor	bac si
please	xin vui long
protect	bao ve
noon	trua
crop	cay trong
modern	hien dai
element	yeu to
hit	nhan
student	sinh vien
corner	goc
party	buoi tiec
supply	cung cap
whose	co
locate	xac dinh vi tri
ring	vong
character	nhan vat
insect	con trung
caught	bat
period	thoi gian
indicate	chi ra
radio	radio
spoke	noi
atom	nguyen tu
human	con nguoi
history	lich su
effect	hieu luc
electric	dien
expect	mong doi
bone	xuong
rail	duong sat
imagine	tuong tuong
provide	cho
agree	dong y
thus	do do
gentle	nhe nhang
woman	nguoi phu nu
captain	doi truong
guess	doan
necessary	can thiet
sharp	sac net
wing	canh
create	tao
neighbor	hang xom
wash	rua
bat	bat
rather	thay
crowd	dam dong
corn	ngo
compare	so sanh
poem	bai tho
string	chuoi
bell	chuong
depend	phu thuoc
meat	thit
rub	cha
tube	ong
famous	noi tieng
dollar	dong dola
stream	song
fear	so hai
sight	canh
thin	mong
triangle	tam giac
planet	hanh tinh
hurry	nhanh
chief	truong
colony	thuoc dia
clock	dong ho
mine	toi
tie	ca vat
enter	nhap
major	chinh
fresh	tuoi
search	tim kiem
send	gui
yellow	vang
gun	sung
allow	cho phep
print	in
dead	chet
spot	tai cho
desert	sa mac
suit	phu hop voi
current	hien tai
lift	thang may
rose	tang
arrive	den
master	chu
track	theo doi
parent	bo me
division	phan chia
sheet	to
substance	chat
favor	ung ho
connect	ket noi
post	bai
spend	chi tieu
chord	hop am
fat	chat beo
glad	vui
original	ban dau
share	chia se
station	tram
dad	cha
bread	banh mi
charge	phi
proper	thich hop
bar	thanh
offer	phuc vu
segment	phan khuc
slave	no le
duck	vit
instant	ngay lap tuc
market	thi truong
degree	muc do
chick	ga
dear	than yeu
enemy	ke thu
reply	tra loi
drink	ly
occur	xay ra
support	ho tro
speech	bai phat bieu
nature	thien nhien
range	pham vi
steam	hoi nuoc
motion	chuyen dong
path	con duong
liquid	chat long
log	dang nhap
meant	co nghia la
quotient	thuong
teeth	rang
shell	vo
neck	co
oxygen	oxy
sugar	duong
death	chet
pretty	kha
skill	ky nang
women	phu nu
season	mua
solution	giai phap
magnet	nam cham
silver	bac
thank	cam on
branch	chi nhanh
match	tran dau
suffix	hau to
especially	dac biet la
fig	sung
afraid	so
huge	to
sister	em gai
steel	thep
discuss	thao luan
forward	ve phia truoc
similar	tuong tu
guide	huong dan
experience	kinh nghiem
score	diem
apple	tao
bought	mua
led	dan
pitch	san
coat	ao
mass	khoi luong
card	the
band	ban nhac
rope	day
slip	truot
win	gianh chien thang
dream	mo
evening	buoi toi
condition	dieu kien
feed	thu can chan nuoi
tool	cong cu
total	tong so
basic	co ban
smell	mui
valley	thung lung
nor	cung khong
double	doi
seat	ghe
continue	tiep tuc
block	khoi
chart	bieu do
hat	mu
sell	ban
success	thanh cong
company	cong ty
subtract	tru
event	su kien
particular	rieng
deal	thoa thuan
swim	boi
term	han
opposite	nguoc lai
wife	vo
shoe	giay
shoulder	vai
spread	lay lan
arrange	sap xep
camp	trai
invent	phat minh
cotton	bong
born	sinh
determine	xac dinh
quart	lit
nine	chin
truck	xe tai
noise	tieng on
level	muc
chance	co hoi
gather	thu thap
shop	cua hang
stretch	cang ra
throw	nem
shine	toa sang
property	tai san
column	cot
molecule	phan tu
select	chon
wrong	sai
gray	mau xam
repeat	lap lai
require	yeu cau
broad	rong
prepare	chuan bi
salt	muoi
nose	mui
plural	so nhieu
anger	tuc gian
claim	xin
continent	luc