//Dictionary
a	nho, mot it
abandon	bo, tu bo
abandoned	bi bo roi, bi ruong bo
ability	kha nang, nang luc
able	co nang luc, co tai
about	khoang, ve
above	o tren, len tren
abroad	o, ra nuoc ngoai, ngoai troi
absence	su vang mat
absent	vang mat, nghi
absolute	tuyet doi, hoan toan
absolutely	tuyet doi, hoan toan
absorb	thu hut, hap thu, loi cuon
abuse	long hanh, lam dung
academic	thuoc hoc vien, dh, vien han lam
accent	trong am, dau trong am
accept	chap nhan, chap thuan
acceptable	co the chap nhan, chap thuan
access	loi, cua, duong vao
accident	tai nan, rui ro. by accident: tinh co
accidental	tinh co, bat ngo
accidentally	tinh co, ngau nhien
accommodation	su thich nghi, su dieu tiet, su lam cho phu hop
accompany	di theo, di cung, kem theo.
according to	theo, y theo
account	tai khoan, ke toan; tinh toan, tinh den
accurate	dung dan, chinh xac, xac dang
accurately	dung dan, chinh xac
accuse	to cao, buoc toi, ket toi
achieve	dat duoc, danh duoc
achievement	thanh tich, thanh tuu 
acid	axit
acknowledge	cong nhan, thua nhan
acquire	danh duoc, dat duoc, kiem duoc
across	qua, ngang qua
act	hanh dong, hanh vi, cu chi, doi xu
action	hanh dong, hanh vi, tac dong. take action: hanh dong
active	tich cuc hoat dong, nhanh nhen
actively	tich cuc hoat dong; nhanh nhen, linh loi; co hieu luc
activity	su tich cuc, su hoat dong, su nhanh nhen, su linh loi
actor	dien vien nam
actress	dien vien nu
actual	thuc te, co that
actually	hien nay, hien tai
adapt	tra, lap vao
add	cong, them vao
addition	tinh cong, phep cong
additional	them vao, tang them
address	dia chi, de dia chi
adequate	day, day du
adequately	tuong xung, thoa dang
adjust	sua lai cho dung, dieu chinh
admiration	su kham phuc, than phuc
admire	kham phuc, than phuc
admit	nhan vao, cho vao, ket hop
adopt	nhan lam con nuoi, bo me nuoi
adult	nguoi lon, nguoi truong thanh, truong thanh
advance	su tien bo, tien len; dua len, de xuat
advanced	tien tien, tien bo, cap cao. in advance truoc, som
advantage	su thuan loi, loi ich, loi the. take advantage of loi dung 
adventure	su phieu luu, mao hiem
advertise	bao cho biet, bao cho biet truoc
advertisement	quang cao
advertising	su quang cao, nghe quang cao
advice	loi khuyen, loi chi bao
advise	khuyen, khuyen bao, ran bao
affair	viec
affect	lam anh huong, tac dong den
affection	tinh cam, su yeu men
afford	co the, co du kha nang, dieu kien(lam gi)
afraid	so, so hai, hoang so
after	sau, dang sau, sau khi
afternoon	buoi chieu
afterwards	sau nay, ve sau, roi thi, sau day
again	lai, nua, lan nua
against	chong lai, phan doi
age	tuoi
aged	gia di
agency	tac dung, luc; moi gioi, trung gian
agent	dai ly, tac nhan
aggressive	xam luoc, hung hang (us: xong xao)
ago	truoc day
agree	dong y, tan
agreement	su dong y, tan thanh; hiep dinh, hop dong
ahead	truoc, ve phia truoc
aid	su giup do; them vao, phu vao
aim	su nham (ban), muc tieu, y dinh; nham, tap trung, huong vao
air	khong khi, bau khong khi, khong gian
aircraft	may bay, khi cau
airport	san bay, phi truong 
alarm	bao dong, bao nguy
alarmed	bao dong
alarming	lam lo so, lam hot hoang, lam so hai
alcohol	ruou con
alcoholic	ruou; nguoi nghien ruou
alive	song, van con song, con ton tai
all	tat ca
all right	tot, on, khoe manh; duoc
allied	lien minh, dong minh, thong gia
allow	cho phep, de cho
ally	nuoc dong minh, lien minh; lien ket, ket thong gia
almost	hau nhu, gan nhu
alone	co don, mot minh
along	doc theo, theo; theo chieu dai,suot theo
alongside	sat canh, ke ben, doc theo
aloud	lon tieng, to tieng
alphabet	bang chu cai, buoc dau, dieu co ban
alphabetical	thuoc bang chu cai
alphabetically	theo thu tu abc
already	da, roi, da... roi
also	cung, cung vay, cung the
alter	thay doi, bien doi, sua doi
alternative	su lua chon; lua chon
alternatively	nhu mot su lua chon
although	mac du, dau cho
altogether	hoan toan, hau nhu; noi chung
always	luon luon
amaze	lam ngac nhien, lam sung sot
amazed	kinh ngac, sung sot
amazing	kinh ngac, sung sot 
ambition	hoai bao, khat vong
ambulance	xe cuu thuong, xe cap cuu
among	giua, o giua
amount	so luong, so nhieu; len toi(money)
amuse	lam cho vui, thich, lam buon cuoi
amused	vui thich
amusing	vui thich
analyse	phan tich
analysis	su phan tich
ancient	xua, co
and	va
anger	su tuc gian, su gian du
angle	goc
angrily	tuc gian, gian du
angry	gian, tuc gian
animal	dong vat, thu vat
ankle	mat ca chan
anniversary	ngay, le ki niem
announce	bao, thong bao
annoy	choc tuc, lam buc minh; lam phien, quay nhieu
annoyed	bi kho chiu, buc minh, bi quay ray
annoying	choc tuc, lam buc minh; lam phien, quay nhieu
annual	hang nam, tung nam
annually	hang nam, tung nam
another	khac
answer	su tra loi; tra loi
anti	chong lai
anticipate	thay truoc, chan truoc, luong truoc
anxiety	moi lo au, su lo lang
anxious	lo au, lo lang, ban khoan
anxiously	lo au, lo lang, ban khoan 
any	mot nguoi, vat nao do; bat cu; mot chut nao, ti nao
anyone	nguoi nao, bat cu ai
anything	viec gi, vat gi; bat cu viec gi, vat gi
anyway	the nao cung duoc, du sao chang nua
anywhere	bat cu cho nao, bat cu noi dau
apart	ve mot ben, qua mot ben
apartment	can phong, can buong
apologize	xin loi, ta loi
apparent	ro rang, ranh mach; be ngoai, co ve
apparently	nhin ben ngoai, hinh nhu
appeal	su keu goi, loi keu goi; keu goi, cau khan
appear	xuat hien, hien ra, trinh dien
appearance	su xuat hien, su trinh dien
apple	qua tao
application	su gan vao, vat gan vao; su chuyen can, chuyen tam
apply	gan vao, ghep vao, ap dung vao
appoint	bo nhiem, chi dinh, chon
appointment	su bo nhiem, nguoi duoc bo nhiem
appreciate	thay ro; nhan thuc
approach	den gan, lai gan; su den gan, su lai gan
appropriate	thich hop, thich dang
approval	su tan thanh, dong y, su chap thuan
approve	tan thanh, dong y, chap thuan
approving	tan thanh, dong y, chap thuan
approximate	giong voi, giong het voi
approximately	khoang chung, do chung 
april	thang tu
area	dien tich, be mat
argue	chung to, chi ro
argument	ly le
arise	xuat hien, nay ra, nay sinh ra
arm	canh tay; vu trang, trang bi (vu khi)
armed	vu trang
arms	vu khi, binh gioi, binh khi
army	quan doi
around	xung quanh, vong quanh
arrange	sap xep, sap dat, sua soan
arrangement	su sap xep, sap dat, su sua soan
arrest	bat giu, su bat giu
arrival	su den, su toi noi
arrive	den, toi noi
arrow	ten, mui ten
art	nghe thuat, my thuat
article	bai bao, de muc
artificial	nhan tao
artificially	nhan tao
artist	nghe si
artistic	thuoc nghe thuat, thuoc my thuat
as	nhu (as you know...)
as well	cung, cung nhu
ashamed	nguong, xau ho
aside	ve mot ben, sang mot ben. aside from: ngoai ra, tru ra
ask	hoi
asleep	ngu, dang ngu. fall asleep ngu thiep di
aspect	ve be ngoai, dien mao
assist	giup, giup do; tham du, co mat
assistance	su giup do 
assistant	nguoi giup do, nguoi phu ta; giup do
associate	ket giao, lien ket, ket hop, cho cong tac. associated with lien ket voi
association	su ket hop, su lien ket
assume	mang, khoac, co, lay (cai ve, tinh chat...)
assure	dam bao, cam doan
atmosphere	khi quyen
atom	nguyen tu
attach	gan, dan, troi, buoc
attached	gan bo
attack	su tan cong, su cong kich; tan cong, cong kich
attempt	su co gang, su thu; co gang, thu
attempted	co gang, thu
attend	du, co mat
attention	su chu y
attitude	thai do, quan diem
attorney	nguoi duoc uy quyen
attract	hut; thu hut, hap dan
attraction	su hut, suc hut
attractive	hut, thu hut, co duyen, loi cuon
audience	thinh, khan gia
august	thang tam
aunt	co, di
author	tac gia
authority	uy quyen, quyen luc
automatic	tu dong
automatically	mot cach tu dong
autumn	mua thu (us: mua thu la fall)
available	co the dung duoc, co gia tri, hieu luc
average	trung binh, so trung binh, muc trung binh 
avoid	tranh, tranh xa
awake	danh thuc, lam thuc day
award	phan thuong; tang, thuong
aware	biet, nhan thuc, nhan thuc thay
away	xa, xa cach, roi xa, di xa
awful	oai nghiem, de so
awfully	tan khoc, khung khiep
awkward	vung ve, lung tung
awkwardly	vung ve, lung tung
back	lung, sau, ve phia sau, tro lai
background	phia sau; nen
backward	ve phia sau, lui lai
backwards	nguoc
bacteria	vi khuan
bad	xau, toi. go bad ban thiu, thoi, hong
badly	xau, toi
bad-tempered	xau tinh, de noi cau
bag	bao, tui, cap xach
baggage	hanh ly
bake	nung, nuong bang lo
balance	cai can; lam cho can bang, tuong xung
ball	qua bong
ban	cam, cam chi; su cam
band	bang, dai, nep
bandage	dai bang; bang bo
bank	bo (song...) , de
bar	quan ban ruou
bargain	su mac ca, su giao keo mua ban
barrier	dat chuong ngai vat
base	co so, co ban, nen mong; dat ten, dat co so tren cai gi. based on dua tren
basic	co ban, co so
basis	nen tang, co so
bath	su tam
bathroom	buong tam, nha ve sinh
battery	pin, ac quy
battle	tran danh, chien thuat
bay	gian (nha), nhip (cau), chuong (ngua); bays: vong nguyet que, vinh
beach	bai bien
beak	mo chim
bear	mang, cam, vac, deo, om
beard	rau
beat	tieng dap, su dap; danh dap, dam
beautiful	dep
beautifully	tot dep, dang hai long
beauty	ve dep, cai dep; nguoi dep
because	boi vi, vi. because of prep. vi, do boi
become	tro thanh, tro nen
bed	cai giuong
bedroom	phong ngu
beef	thit bo
beer	ruou bia
before	truoc, dang truoc
begin	bat dau, khoi dau
beginning	phan dau, luc bat dau, luc khoi dau
behalf	su thay mat. on behalf of sb thay mat cho ai, nhan danh ai
behave	doi xu, an o, cu xu
behaviour	thai do, cach doi xu; cach cu xu, >cach an o; tu cach dao duc
behind	sau, o dang sau
belief	long tin, duc tin, su tin tuong
believe	tin, tin tuong
bell	cai chuong, tieng chuong
belong	thuoc ve, cua, thuoc quyen so huu
below	o duoi, duoi thap, phia duoi
belt	day lung, that lung
bend	cho re, cho uon; khuyu tay; cui >xuong, uon cong
beneath	o duoi, duoi thap
benefit	loi, loi ich; giup ich, lam loi cho
bent	khieu, so thich, khuynh huong
beside	ben canh, so voi
bet	danh cuoc, ca cuoc; su danh >cuoc
better	tot hon
best	tot nhat
betting	su danh cuoc
between	giua, o giua
beyond	o >xa, phia ben kia
bicycle	xe dap
bid	dat gia, tra gia; su dat gia, su tra >gia
big	to, lon
bill	hoa don, giay bac
bin	thung, thung dung ruou
biology	sinh vat hoc
bird	chim
birth	su ra doi, su sinh de
birthday	ngay sinh, sinh nhat
biscuit	banh quy
bit	mieng, manh. a bit mot chut, mot t
bite	can, ngoam; su can, su ngoam
bitter	dang; dang cay, chua xot
bitterly	dang, dang cay, chua xot
black	den; mau den
bowl	cai bat
box	hop, thung
boy	con trai, thieu nien
boyfriend	ban trai
brain	oc nao; dau oc, tri nao
branch	nganh; nhanh cay, nhanh song, >nga duong
brand	nhan (hang hoa)
brave	gan da, can dam
bread	banh my
break	be gay, dap vo; su >gay, su vo
breakfast	bua diem tam, bua sang
breast	nguc, vu
breath	hoi tho, hoi
breathe	hit, tho
breathing	su ho hap, su tho
breed	nuoi duong, cham soc, giao duc; >sinh de; noi giong
brick	gach
bridge	cai cau
brief	ngan, gon, van tat
briefly	ngan, gon, van tat, tom tat
bright	sang, sang choi
brightly	sang choi, tuoi
brilliant	toa sang, ruc ro, choi loi
bring	mang, cam , xach lai
broad	rong
broadcast	tung ra khap noi,truyen rong rai; >phat thanh, quang ba
broadly	rong, rong rai
broken	bi >gay, bi vo
brother	anh, em trai
brown	nau, mau nau
brush	ban chai; chai, quet
bubble	bong bong, bot, tam
budget	ngan sach
build	xay dung
building	su xay >dung, cong trinh xay dung >toa nha
bullet	dan (sung truong, sung luc)
bunch	bui, chum, bo, cum, buong; bay, >dan
burn	dot, dot chay, thap, nung, thieu
burnt	bi dot, bi chay, khe; ram nang, >sam (da)
burst	no, no tung (bom, dan); no, vo >(bong bong); hao huc
bury	chon cat, mai tang
bus	xe buyt
bush	bui cay, bui ram
business	viec buon ban, thuong mai, kinh >doanh
busy	ban, ban ron
but	nhung
butter	bo
button	cai nut, cai khuy, cuc
buy	mua
buyer	nguoi mua
by	boi, bang
bye	tam biet
cabinet	tu co nhieu ngan dung do
cable	day cap
cake	banh ngot
calculate	tinh toan
calculation	su tinh toan
call	goi; tieng keu, tieng goi. be called: >duoc goi, bi goi
calm	yen lang, lam diu di; su yen lang, >su em a
calmly	yen lang, em a; binh tinh, diem tinh
camera	may anh
camp	trai, cho cam trai; cam trai, ha trai
campaign	chien dich, cuoc van dong
camping	su cam trai
can	co the; nha tu, nha giam, binh, ca dung. cannot khong the
cancel	huy bo, xoa bo
cancer	benh ung thu
candidate	nguoi ung cu, thi sinh, nguoi du thi
candy	keo
cap	mu luoi trai, mu vai
capable	co tai, co nang luc; co kha nang, ca gan
capacity	nang luc, kha nang tiep thu, nang suat
capital	thu do, tien von; chu yeu, chinh yeu, co ban
captain	nguoi cam dau, nguoi chi huy, thu linh
capture	bat giu, bat; su bat giu, su bi bat
car	xe hoi
card	the, thiep
cardboard	bia cung, cac tong
care	su cham soc, cham nom; cham soc
career	nghe nghiep, su nghiep
careful	can than, can trong, biet giu gin
carefully	can than, chu dao
careless	so suat, cau tha
carelessly	cau tha, bat can
carpet	tam tham, tham (co)
carrot	cu ca rot
carry	mang, vac, khuan cho
case	vo, ngan, tui,truong hop, canh ngo, hoan canh, tinh the
cash	tien, tien mat
cast	quang, nem, tha, danh guc; su quang, su nem (luoi), su tha (neo)
castle	thanh tri, thanh quach
cat	con meo
catch	bat lay, nam lay, tom lay, chop lay
category	hang, loai; pham tru
cause	nguyen nhan, nguyen do; gay ra, gay nen
cd	dia cd
cease	dung, ngung, ngot, thoi, het, tanh
ceiling	tran nha
celebrate	ky niem, lam le ky niem; tan duong, ca tung
celebration	su ky niem, le ky niem; su tan duong, su ca tung
cell	o, ngan
cent	dong xu (bang 1/100 do la)
centimetre	xen ti met
central	trung tam, o giua, trung uong
centre	diem giua, trung tam, trung uong
century	the ky
ceremony	nghi thuc, nghi le
certain	chac chan
certainly	chac chan, nhat dinh
certificate	giay chung nhan, bang, chung chi
chain	day, xich; xinh lai, troi lai
chair	ghe
challenge	su thu thach, su thach thuc; thach thuc, thu thach 
chamber	buong, phong, buong ngu
chance	su may rui, su tinh co, ngau nhien
change	thay doi, su thay doi, su bien doi
channel	kenh (tv, radio), eo bien
chapter	chuong (sach)
character	tinh cach, dac tinh, nhan vat
characteristic	rieng, rieng biet, dac trung, dac tinh, dac diem
charge	nhiem vu, bon phan, trach nhiem; giao nhiem vu, giao viec. in charge of phu trach
charity	long tu thien, long nhan duc; su bo thi
chart	do thi, bieu do; ve do thi, lap bieu do
chase	san bat; su san bat
chat	noi chuyen, tan gau; chuyen phiem, chuyen gau
cheap	re
cheaply	re, re tien
cheat	lua, lua dao; tro lua dao, tro gian lan
check	kiem tra; su kiem tra
cheek	ma
cheerful	vui mung, phan khoi, ho hoi
cheerfully	vui ve, phan khoi
cheese	pho mat
chemical	thuoc hoa hoc; chat hoa hoc, hoa chat
chemist	nha hoa hoc
chemistry	hoa hoc, mon hoa hoc, nganh hoa hoc
cheque	sec
chest	tu, ruong, hom
chew	nhai, ngam nghi 
chicken	ga, ga con, thit ga
chief	trong yeu, chinh yeu; thu linh, lanh tu, nguoi dung dau, xep
child	dua be, dua tre
chin	cam
chip	vo bao, manh vo, cho sut, me
chocolate	so co la
choice	su lua chon
choose	chon, lua chon
chop	chat, don, che
church	nha tho
cigarette	dieu thuoc la
cinema	rap xi ne, rap chieu bong
circle	duong tron, hinh tron
circumstance	hoan canh, truong hop, tinh huong
citizen	nguoi thanh thi
city	thanh pho
civil	(thuoc) cong dan
claim	doi hoi, yeu sach; su doi hoi, su yeu sach, su thinh cau
clap	vo, vo tay; tieng no, tieng vo tay
class	lop hoc
classic	co dien, kinh dien
classroom	lop hoc, phong hoc
clean	sach, sach se;
clear	lau chui, quet don
clearly	ro rang, sang sua
clerk	thu ky, linh muc, muc su
clever	lanh loi, thong minh. tai gioi, kheo leo
click	lam thanh tieng lach cach; tieng lach cach, cu nhap (chuot)
client	khach hang
climate	khi hau, thoi tiet 
climb	leo, treo
climbing	su leo treo
clock	dong ho
close	dong kin, chat choi, che day
closed	bao thu, khong coi mo, khep kin
closely	chat che, ky luong, ti mi
closet	buong, phong de do, phong kho
cloth	vai, khan trai ban, ao thay tu
clothes	quan ao
clothing	quan ao, y phuc
cloud	may, dam may
club	cau lac bo; gay, dui cui
coach	huan luyen vien
coal	than da
coast	su lao doc; bo bien
coat	ao choang
code	mat ma, luat, dieu le
coffee	ca phe
coin	tien kim loai
cold	lanh, su lanh leo, lanh nhat
coldly	lanh nhat, ho hung, vo tam
collapse	do, sup do; su do nat, su sup do
colleague	ban dong nghiep
collect	suu tap, tap trung lai
collection	su suu tap, su tu hop
college	truong cao dang, truong dai hoc
color	mau sac; to mau
colored	mang mau sac, co mau sac
column	cot , muc (bao)
combination	su ket hop, su phoi hop
combine	ket hop, phoi hop
come	den, toi, di den, di toi
comedy	hai kich 
comfort	su an ui, khuyen giai, loi dong vien, su an nhan; do danh, an ui
comfortable	thoai mai, tien nghi, day du
comfortably	de chiu, thoai mai, tien nghi, am cung
command	ra lenh, chi huy; lenh, menh lenh, quyen ra lenh, quyen chi huy
comment	loi binh luan, loi chu giai; binh luan, phe binh, chu thich, dan giai
commercial	buon ban, thuong mai
commission	hoi dong, uy ban, su uy nhiem, su uy thac; uy nhiem, uy thac
commit	giao, gui, uy nhiem, uy thac; tong giam, bo tu
commitment	su pham toi, su tan tuy, tan tam
committee	uy ban
common	cong, cong cong, thong thuong, pho bien. in common su chung, cua chung
commonly	thong thuong, binh thuong
communicate	truyen, truyen dat; giao thiep, lien lac
communication	su giao tiep, lien lac, su truyen dat, truyen tin
community	dan chung, nhan dan
company	cong ty
compare	so sanh, doi chieu
comparison	su so sanh
compete	dua tranh, ganh dua, canh tranh
competition	su canh tranh, cuoc thi, cuoc thi dau
competitive	canh tranh, dua tranh
complain	phan nan, keu ca
complaint	loi than phien, than tho; su khieu nai, don kien
complete	hoan thanh, xong;
completely	hoan thanh, day du, tron ven
complex	phuc tap, rac roi 
complicate	lam phuc tap, rac roi
complicated	phuc tap, rac roi
computer	may tinh
concentrate	tap trung
concentration	su tap trung, noi tap trung
concept	khai niem
concern	lien quan, dinh liu toi; su lien quan, su dinh liu toi
concerned	co lien quan, co dinh liu
concerning	co lien quan, dinh liu toi
concert	buoi hoa nhac
conclude	ket luan, ket thuc, cham dut (cong viec)
conclusion	su ket thuc, su ket luan, phan ket luan
concrete	bang be tong; be tong
condition	dieu kien, tinh canh, tinh the
conduct	dieu khien, chi dao, chi huy; su dieu khien, chi huy
conference	hoi nghi, su ban bac
confidence	long tin tuong, su tin cay
confident	tin tuong, tin cay, tu tin
confidently	tu tin
confine	giam giu, han che
confined	han che, gioi han
confirm	xac nhan, chung thuc
conflict	xung dot, va cham; su xung dot, su va cham
confront	doi mat, doi dien, doi chieu
confuse	lam lon xon, xao tron
confused	boi roi, lung tung, nguong
confusing	kho hieu, gay boi roi
confusion	su lon xon, su roi loan
congratulations	su chuc mung, khen ngoi; loi chuc mung, khen ngoi (s)
congress	dai hoi, hoi nghi, quoc hoi
connect	ket noi, noi
connection	su ket noi, su giao ket
conscious	tinh tao, co y thuc, biet ro
consequence	ket qua, hau qua
conservative	than trong, de dat, bao thu
consider	can nhac, xem xet; de y, quan tam, luu y den
considerable	lon lao, to tat, dang ke
considerably	dang ke, lon lao, nhieu
consideration	su can nhac, su xem xet, su de y, su quan tam
consist of	gom co
constant	kien tri, ben long
constantly	kien dinh
construct	xay dung
construction	su xay dung
consult	tra cuu, tham khao, tham do, hoi y kien
consumer	nguoi tieu dung
contact	su lien lac, su giao thiep; tiep xuc
contain	bao ham, chua dung, bao gom
container	cai dung, chua; cong te no
contemporary	duong thoi, duong dai
content	noi dung, su hai long
contest	cuoc thi, tran dau, cuoc tranh luan cuoc chien dau, chien tranh
context	van canh, khung canh, pham vi
continent	luc dia, dai luc (luc dia bac my)
continue	tiep tuc, lam tiep
continuous	lien tuc, lien tiep
continuously	lien tuc, lien tiep
contract	hop dong, su ky hop dong; ky ket
contrast	su tuong phan; lam tuong phan, lam trai nguoc
contrasting	tuong phan
contribute	dong gop, ghop phan
contribution	su dong gop, su gop phan
control	su dieu khien, quyen hanh, quyen luc, quyen chi huy
controlled	duoc dieu khien, duoc kiem tra
convenient	tien loi, thuan loi, thich hop
convention	hoi nghi, hiep dinh, quy uoc
conventional	quy uoc
conversation	cuoc dam thoai, cuoc tro chuyen
convert	doi, bien doi
convince	lam cho tin, thuyet phuc; lam cho nhan thuc thay
cook	nau an, nguoi nau an
cooker	lo, bep, noi nau
cookie	banh quy
cooking	su nau an, cach nau an
cool	mat me, diem tinh; lam mat,
cope	doi pho, duong dau
copy	ban sao, ban chep lai; su sao chep; sao chep, bat chuoc
core	nong cot, hat nhan; day long
corner	goc (tuong, nha, pho...)
correct	dung, chinh xac; sua, sua chua
correctly	dung, chinh xac
cost	gia, chi phi; tra gia, phai tra
cottage	nha tranh
cotton	bong, chi, soi
cough	ho, su ho, tieng hoa
coughing	ho
could	co the
council	hoi dong
count	dem, tinh
counter	quay hang, quay thu tien, may dem
country	nuoc, quoc gia, dat nuoc
countryside	mien que, mien nong thon
county	hat, tinh
couple	doi, cap; doi vo chong, cap nam nu. a couple mot cap, mot doi
courage	su can dam, su dung cam, dung khi
course	tien trinh, qua trinh dien tien; san chay dua. of course di nhien, loat; khoa; dot; lop
court	san, san (tennis...), toa an, quan toa, phien toa
cousin	anh em ho
cover	bao boc, che phu; vo, vo boc
covered	co mai che, kin dao
covering	su bao boc, su che phu, cai bao, boc
cow	con bo cai
crack	cu, xuat sac; lam nut, lam vo, nut ne, ran nut
cracked	ran, nut
craft	nghe, nghe thu cong
crash	vai tho; su roi (may bay), su pha san, sup do; pha tan tanh, pha vun
crazy	dien, mat tri
cream	kem
create	sang tao, tao nen
creature	sinh vat, loai vat
credit	su tin, long tin, danh tieng; tien gu ngan hang
crime	toi, toi ac, toi pham
criminal	co toi, pham toi; ke pham toi, toi pham
crisis	su khung hoang, con khung hoang
crisp	gion
criterion	tieu chuan
critical	phe binh, phe phan; kho tinh
criticism	su phe binh, su phe phan, loi phe binh, loi phe phan
criticize	phe binh, phe phan, chi trich
crop	vu mua
cross	cay thanh gia, noi thong kho; su bang qua; bang qua, vuot qua
crowd	dam dong
crowded	dong duc
crown	vuong mien, vua, ngai vang; dinh cao nhat
crucial	quyet dinh, cot yeu, chu yeu
cruel	doc ac, du ton, tan nhan
crush	ep, vat, de nat, de bep
cry	khoc, keu la; su khoc, tieng khoc, su keu la
cultural	(thuoc) van hoa
culture	van hoa, su mo mang, su giao duc
cup	tach, chen
cupboard	1 loai tu co ngan
curb	kiem che, nen lai, han che
cure	chua tri, dieu tri; cach chua benh, cach dieu tri; thuoc
curious	ham muon, to mo, la lung
curiously	to mo, hieu ky, la ky
curl	quan, xoan, uon quan, lam xoan; su uon quan
curly	quan, xoan
current	hien hanh, pho bien, hien nay; dong (nuoc), luong (gio)
currently	hien thoi, hien nay
curtain	man (cua, rap hat, khoi, suong)
curve	duong cong, duong vong; cong, uon cong, be cong
curved	cong
custom	phong tuc, tuc le, thoi quen, tap quan
customer	khach hang
customs	thue nhap khau, hai quan
cut	cat, chat; su cat
cycle	chu ky, chu trinh, vong; quay vong theo chu ky, di xe dap
cycling	su di xe dap
dad	bo, cha
daily	hang ngay
damage	moi han, dieu hai, su thiet hai; lam hu hai, lam hong, gay thiet hai
damp	am, am uot, am thap
dance	su nhay mua, su khieu vu; nhay mua, khieu vu
dancer	dien vien mua, nguoi nhay mua
dancing	su nhay mua, su khieu vu
danger	su nguy hiem, moi hiem ngheo; nguy co, moi de doa
dangerous	nguy hiem
dare	dam, dam duong dau voi; thach
dark	toi, toi tam; bong toi, am muoi
data	so lieu, du lieu
date	ngay, ky, ky han, thoi ky, thoi dai; de ngay thang, ghi nien hieu
daughter	con gai
day	ngay, ban ngay
dead	chet, tat
deaf	diec, lam thinh, lam ngo
deal	phan phat, phan phoi; su giao dich, thoa thuan mua ban. deal with giai quyet
dear	than, than yeu, than men; kinh thua, thua
death	su chet, cai chet
debate	cuoc tranh luan, cuoc tranh cai; tranh luan, ban cai
debt	no
decade	thap ky, bo muoi, nhom muoi
decay	tinh trang suy tan, suy sup, tinh trang do nat
december	thang muoi hai, thang chap
decide	quyet dinh, giai quyet, phan xu
decision	su quyet dinh, su giai quyet, su phan xu
declare	tuyen bo, cong bo
decline	su suy tan, su suy sup; suy sup, suy tan
decorate	trang hoang, trang tri
decoration	su trang hoang, do trang hoang, trang tri
decorative	de trang hoang, de trang tri, de lam canh
decrease	giam bot, lam suy giam, su giam di, su giam sut
deep	sau, kho luong, bi an
deeply	sau, sau xa, sau sac
defeat	danh thang, danh bai; su that bai (1 ke hoach), su tieu tan (hyvong..)
defence	cai de bao ve, vat de chong do, su che cho
defend	che cho, bao ve, bao chua
define	dinh nghia
definite	xac dinh, dinh ro, ro rang
definitely	rach roi, dut khoat
definition	su dinh nghia, loi dinh nghia
degree	muc do, trinh do; bang cap; do
delay	su cham tre, su tri hoan, su can tro; lam cham tre
deliberate	than trong, co tinh toan, chu tam, co suy nghi can nhac
deliberately	than trong, co suy nghi can nhac
delicate	thanh nha, thanh tu, te nhi, kho xu
delight	su vui thich, su vui suong, dieu thich thu; lam vui thich, lam say me
delighted	vui mung, hai long
deliver	cuu khoi, thoat khoi, bay to, giai bay
delivery	su phan phat, su phan phoi, su giao hang; su bay to, phat bieu
demand	su doi hoi, su yeu cau; doi hoi, yeu cau
demonstrate	chung minh, giai thich; bay to, bieu lo
dentist	nha si
deny	tu choi, phan doi, phu nhan
department	cuc, so, ty, ban, khoa; gian hang, khu bay hang
departure	su roi khoi, su di, su khoi hanh
depend	phu thuoc, tuy thuoc; dua vao, y vao, trong mong vao
deposit	vat gui, tien gui, tien dat coc; gui, dat coc
depress	lam chan nan, lam phien muon; lam suy giam
depressed	chan nan, that vong, phien muon; suy yeu, dinh tre
depressing	lam chan nan lam that vong, lam tri tre
depth	chieu sau, do day
derive	nhan duoc tu, lay duoc tu; xuat phat tu, bat nguon, chuyen hoa tu (from)
describe	dien ta, mieu ta, mo ta
description	su mo ta, su ta, su mieu ta
desert	sa mac; cong lao, gia tri; roi bo, bo tron
deserted	hoang vang, khong nguoi o
deserve	dang, xung dang
design	su thiet ke, ke hoach, de cuong. phac thao; phac hoa, thiet ke
desire	uoc muon; them muon, ao uoc
desk	ban (hoc sinh, viet, lam viec)
desperate	lieu mang, lieu linh; tuyet vong
desperately	lieu linh, lieu mang
despite	du, mac du, bat chap
destroy	pha, pha hoai, pha huy, tieu diet, triet pha
destruction	su pha hoai, su pha huy, su tieu diet
detail	chi tiet. in detail: tuong tan, ti mi
detailed	can ke, ti mi, nhieu chi tiet
determination	su xac dinh, su dinh ro; su quyet dinh
determine	xac dinh, dinh ro; quyet dinh
determined	da duoc xac dinh, da duoc xac dinh ro
develop	phat trien, mo rong; trinh bay, bay to
development	su phat trien, su trinh bay, su bay to
device	ke sach; thiet bi, dung cu, may moc
devote	hien dang, danh het cho
devoted	hien cho, dang cho, danh cho; het long, nhiet tinh
diagram	bieu do
diamond	kim cuong
diary	so nhat ky; lich ghi nho
dictionary	tu dien
die	chet, tu tran, hy sinh
diet	che do an uong, che do an kieng
difference	su khac nhau
different	khac, khac biet, khac nhau
differently	khac, khac biet, khac nhau
difficult	kho, kho khan, gay go
difficulty	su kho khan, noi kho khan, dieu can tro
dig	dao boi, xoi
dinner	bua trua, chieu
direct	truc tiep, thang, thang than; gui, viet cho ai, dieu khien
direction	su dieu khien, su chi huy
directly	truc tiep, thang
director	giam doc, nguoi dieu khien, chi huy
dirt	do ban thiu, do do ban, vat rac ruoi
dirty	ban thiu, do ban
disabled	bat luc, khong co kha nang
disadvantage	su bat loi, su thiet hai
disagree	bat dong, khong dong y, khac, khong giong; khong hop
disagreement	su bat dong, su khong dong y, su khac nhau
disappear	bien mat, bien di
disappoint	khong lam thoa uoc nguyen, y mong doi; that uoc, lam that bai
disappointed	that vong
disappointing	lam chan ngan, lam that vong
disappointment	su chan ngan, su that vong
disapproval	su phan doi, su khong tan thanh
disapprove	khong tan thanh, phan doi, che
disapproving	phan doi
disaster	tai hoa, tham hoa
disc	dia
discipline	ky luat
discount	su bot gia, su chiet khau, tien bot chiet khau
discover	kham pha, phat hien ra, nhan ra
discovery	su kham pha, su tim ra, su phat hien ra
discuss	thao luan, tranh luan
discussion	su thao luan, su tranh luan
disease	can benh, benh tat
disgust	lam ghe tom, lam kinh tom, lam phan no
disgusted	chan ghet, phan no
disgusting	lam ghe tom, kinh tom
dish	dia (dung thuc an)
dishonest	bat luong, khong thanh that
dishonestly	bat luong, khong luong thien
disk	dia, dia hat
dislike	su khong ua, khong thich, su ghe
dismiss	giai tan (quan doi, dam dong); sa thai (nguoi lam)
display	bay to, pho truong, trung bay; su bay ra, pho bay, trung bay
dissolve	tan ra, phan huy, giai tan
distance	khoang cach, tam xa
distinguish	phan biet, nhan ra, nghe ra
distribute	phan bo, phan phoi, sap xep, phan loai
distribution	su phan bo, su phan phoi, phan phat, su sap xep
district	huyen, quan
disturb	lam mat yen tinh, lam nao dong, quay ray
disturbing	xao tron
divide	chia, chia ra, phan ra
division	su chia, su phan chia, su phan loai
divorce	su ly di
divorced	da ly di
do	lam
doctor	bac si y khoa, tien si
document	van kien, tai lieu, tu lieu
dog	cho
dollar	do la my
domestic	vat nuoi trong nha, (thuoc) noi tro, quoc noi
dominate	chiem uu the, co anh huong, chi phoi; kiem che
door	cua, cua ra vao
dot	cham nho, diem; cua hoi mon
double	doi, hai, kep; cai gap doi, luong gap doi; lam gap doi
doubt	su nghi ngo, su ngo vuc; nghi ngo, ngo vuc
down	xuong
downstairs	o duoi nha, o tang duoi; xong gac; tang duoi
downward	xuong, di xuong
downwards	xuong, di xuong
dozen	ta (12)
draft	ban phac thao, so do thiet ke; phac thao, thiet ke
drag	loi keo, keo le
drama	kich, tuong
dramatic	nhu kich, nhu dong kich, thich hop voi san khau
dramatically	dot ngot
draw	ve, keo
drawer	nguoi ve, nguoi keo
drawing	ban ve, buc ve, su keo
dream	giac mo, mo
dress	quan ao, mac (quan ao), an mac
dressed	cach an mac
drink	do uong; uong
drive	lai , dua xe; cuoc dua xe (dieu khien)
driver	nguoi lai xe
driving	su lai xe, cuoc dua xe
drop	chay nho giot, roi, rot; giot (nuoc, mau...)
drug	thuoc, duoc pham; ma tuy
drugstore	hieu thuoc, cua hang duoc pham
drum	cai trong, tieng trong
enjoy	thuong thuc, thich thu cai gi, duoc huong, co duoc
enjoyable	thu vi, thich thu
enjoyment	su thich thu, su co duoc, duoc huong
enormous	to lon, khong lo
enough	du
enquiry	su dieu tra, su tham van
ensure	bao dam, chac chan
enter	di vao, gia nhap
entertain	giai tri, tiep don, chieu dai
entertainer	nguoi quan tro, nguoi tiep dai, chieu dai
entertaining	giai tri
entertainment	su giai tri, su tiep dai, chieu dai
enthusiasm	su hang hai, su nhiet tinh
enthusiastic	hang hai, say me, nhiet tinh
entire	toan the, toan bo
entirely	toan ven, tron ven, toan bo
entitle	cho tieu de, cho ten (sach); cho quyen lam gi
entrance	su di vao, su nham chuc
entry	su ghi vao so sach, su di vao, su tiep nhan (phap ly)
envelope	phong bi
environment	moi truong, hoan canh xung quanh
environmental	thuoc ve moi truong
equal	ngang, bang; nguoi ngang hang, ngang tai, suc; bang, ngang
equally	bang nhau, ngang bang
equipment	trang, thiet bi
equivalent	tuong duong; tu, vat tuong duong
error	loi, su sai sot, sai lam
escape	tron thoat, thoat khoi; su tron thoat, loi thoat
especially	dac biet la, nhat la
essay	bai tieu luan
essential	ban chat, thuc chat, cot yeu; yeu to can thiet
essentially	ve ban chat, ve co ban
establish	lap, thanh lap
estate	tai san, di san, bat dong san
estimate	su uoc luong, danh gia; uoc luong, danh gia
etc	van van
euro	don vi tien te cua lien minh chau au
even	ngay ca, ngay, lai con; bang phang, diem dam, ngang bang
evening	buoi chieu, toi
event	su viec, su kien
eventually	cuoi cung
ever	tung, tu truoc toi gio
every	moi, moi
everyone	moi nguoi
everything	moi vat, moi thu
everywhere	moi noi
evidence	dieu hien nhien, dieu ro rang
evil	xau, ac; dieu xau, dieu ac, dieu tai hai
exact	chinh xac, dung
exactly	chinh xac, dung dan
exaggerate	cuong dieu, phong dai
exaggerated	cuong dieu, phong dai
exam	viet tat cua examination (xem nghia phia duoi)
examination	su thi cu, ky thi
examine	tham tra, kham xet, hoi han (thi sinh)
example	thi du, vi du
excellent	xuat sac, xuat chung
except	tru ra, khong ke; tru phi
exception	su tru ra, su loai ra
exchange	trao doi; su trao doi
excite	kich thich, kich dong
excited	bi kich thich, bi kich dong
excitement	su kich thich, su kich dong
exciting	hung thu, thu vi
exclude	ngan chan, loai tru
excluding	ngoai ra, tru ra
excuse	loi xin loi, bao chua; xin loi, tha thu, tha loi
executive	su thi hanh, chap hanh; (thuoc) su thi hanh, chap hanh
exercise	bai tap, su thi hanh, su thuc hien; lam, thi hanh, thuc hien
exhibit	trung bay, trien lam; vat trung bay vat trien lam
exhibition	cuoc trien lam, trung bay
exist	ton tai, song
existence	su ton tai, su song
exit	loi ra, su di ra, thoat ra
expand	mo rong, phat trien, no, gian ra
expect	cho doi, mong ngong; lieu truoc
expectation	su mong cho, su cho doi
expected	duoc cho doi, duoc hy vong
expense	chi phi
expensive	dat
experience	kinh nghiem; trai qua, nem mui
experienced	co kinh nghiem, tung trai, giau kinh nghiem
experiment	cuoc thi nghiem; thi nghiem
expert	chuyen gia; chuyen mon, thanh thao
explain	giai nghia, giai thich
explanation	su giai nghia, giai thich
explode	dap tan (hy vong...), lam no, no
explore	tham do, tham hiem
explosion	su no, su phat trien o at
export	xuat khau; hang xuat khau, su xuat khau
expose	trung bay, phoi bay
express	dien ta, bieu lo, bay to; nhanh, toc hanh
expression	su dien ta, su bay to, bieu lo, su dien dat
extend	gio, duoi ra (tay, cha(n).); keo dai (thoi gia(n).), danh cho, gui loi
extension	su gio, duoi; su keo dai, su danh cho, gui loi
extensive	rong rai, bao quat
extent	quy mo, pham vi
extra	them, phu, ngoai; thu them, phu
extraordinary	dac biet, la thuong, khac thuong
extreme	vo cung, khac nghiet, qua khich, cuc doan; su qua khich
extremely	vo cung, cuc do
eye	mat
face	mat, the dien; duong dau, doi pho doi mat
facility	dieu kien de dang, su de dang, thuan loi
fact	viec, su viec, su kien
factor	nhan to
factory	nha may, xi nghiep, xuong
fail	sai, that bai
failure	su that bai, nguoi that bai
faint	nhut nhat, yeu ot
faintly	nhut nhat, yeu ot
fair	hop ly, cong bang; thuan loi
fairly	hop ly, cong bang
faith	su tin tuong, tin cay; niem tin, vat dam bao
faithful	trung thanh, chung thuy, trung thuc
faithfully	trung thanh, chung thuy, trung thuc. yours faithfully ban chan thanh
fall	roi, nga, su roi, nga. fall over nga lon nhao, bi do
false	sai, nham, gia doi
fame	ten tuoi, danh tieng
familiar	than thiet, quen thoc
family	gia dinh, thuoc gia dinh
famous	noi tieng
fan	nguoi ham mo
fancy	tuong tuong, cho, nghi rang; tuong tuong
far	xa
farm	trang trai
farmer	nong dan, nguoi chu trai
farming	cong viec trong trot, dong ang
fashion	mot, thoi trang
fashionable	dung mot, hop thoi trang
fast	nhanh
fasten	buoc, troi
fat	beo, beo bo; mo, chat beo
father	cha (bo)
faucet	voi (o thung ruou....)
fault	su thiet sot, sai sot
favour	thien y, su quy men; su dong y; su chieu co. in favour/favor (of): ung ho cai gi (to be in favour of something )
favourite	duoc ua thich; nguoi (vat) duoc ua thich
fear	su so hai, e so; so, lo ngai
feather	long chim
feature	net dat biet, diem dac trung; mo ta net dac biet, dac trung cua...
february	thang 2
federal	lien bang
fee	tien thu lao, hoc phi
feed	cho an, nuoi
feel	cam thay
feeling	su cam thay, cam giac
fellow	anh chang (dang yeu), dong chi
female	thuoc giong cai; giong cai
fence	hang rao
festival	le hoi, dai hoi lien hoan
fetch	tim ve, dem ve; lam buc minh; lam say me, quyen ru
fever	con sot, benh sot
few	it,vai; mot it, mot vai. a few mot it, mot vai
field	canh dong, bai chien truong
fight	dau tranh, chien dau; su dau tranh, cuoc chien dau
fighting	su chien dau, su dau tranh
figure	hinh dang, nhan vat; hinh dung, mieu ta
file	ho so, tai lieu
fill	lam day, lap kin
film	phim, duoc dung thanh phim
final	cuoi cung, cuoc dau chung ket
finally	cuoi cung, sau cung
finance	tai chinh; tai tro, cap von
financial	thuoc (tai chinh)
find	tim, tim thay. find out sth: kham pha, tim ra
fine	tot, gioi
finely	dep de, te nhi, cao thuong
finger	ngon tay
finish	ket thuc, hoan thanh; su ket thuc, phan cuoi
finished	hoan tat, hoan thanh
fire	lua; dot chay. set fire to: dot chay cai gi
firm	hang, cong ty; chac, kien quyet, vung vang, manh me
firmly	vung chac, kien quyet
first	thu nhat, dau tien, truoc het; nguoi, vat dau tien, thu nhat. at first truc tiep
fish	ca, mon ca; cau ca, bat ca
fishing	su cau ca, su danh ca
fit	hop, vua; thich hop, xung dang
fix	dong, gan, lap; sua chua, sua sang
fixed	dung yen, bat dong
flag	quoc ky
flame	ngon lua
flash	loe sang, vut sang; anh sang loe len, den nhay
flat	bang phang, bet, nhan; day phong, can phong, mat phang
flavour	vi, mui; cho gia vi, lam tang them mui vi
flesh	thit
flight	su bo chay, rut chay; su bay, chuyen bay
float	noi, troi, lo lung
flood	lut, lu lutl; tran day, tran ngap
floor	san, tang (nha)
flour	bot, bot my
flow	su chay; chay
flower	hoa, bong, doa, cay hoa
flu	benh cum
fly	bay; su bay, quang duong bay
flying	biet bay; su bay, chuyen bay
focus	tap trung; trung tam, trong tam ((n)bong)
fold	gap, ven, xan; nep gap
folding	gap lai duoc
follow	di theo sau, theo, tiep theo
following	tiep theo, theo sau, sau day; sau, tiep theo
food	do an, thuc, mon an
foot	chan, ban chan
football	bong da
for	cho, danh cho...
force	suc manh; ep buoc, cuong ep
forecast	su du doan, du bao; du doan, du bao
foreign	(thuoc) nuoc ngoai, tu nuoc ngoai, o nuoc ngoai
forest	rung
forever	mai mai
forget	quen
forgive	tha, tha thu
fork	cai nia
form	hinh the, hinh dang, hinh thuc; lam thanh, duoc tao thanh
formal	hinh thuc
formally	chinh thuc
former	truoc, cu, xua, nguyen
formerly	truoc day, thuo xua
formula	cong thuc, the thuc, cach thuc
fortune	su giau co, su thinh vuong
forward	o phia truoc, tien ve phia truoc
found	tim, tim thay
foundation	su thanh lap, su sang lap; to chuc
frame	cau truc, he thong; dan xep, bo tri
free	mien phi, tu do, giai phong, tra tu do
freedom	su tu do; nen tu do
freely	tu do, thoai mai
freeze	dong bang, dong lanh
frequent	thuong xuyen
frequently	thuong xuyen
fresh	tuoi, tuoi tan
freshly	tuoi mat, khoe khoan
friday	thu sau
fridge	tu lanh
friend	nguoi ban
friendly	than thien, than mat
friendship	tinh ban, tinh huu nghi
frighten	lam so, lam hoang so
frightened	hoang so, khiep so
frightening	kinh khung, khung khiep
from	frəm/ tu
front	mat; dang truoc, ve phia truoc. in front (of): o phia truoc
frozen	lanh gia
fruit	qua, trai cay
fry	ran, chien; thit ran
fuel	chat dot, nhien lieu
full	day, day du
fully	day du, hoan toan
fun	su vui dua, su vui thich; hai huoc make fun of: dua cot, che gieu, che nhao
function	chuc nang; hoat dong, chay (may)
fund	kho, quy; tai tro, tien bac, de tien vao cong quy
fundamental	co ban, co so, chu yeu
funeral	le tang, dam tang
funny	buon cuoi, khoi hai
fur	bo da long thu
furniture	do dac (trong nha)
further	xa hon nua; them nua
future	tuong lai
gain	loi, loi ich; gianh duoc, kiem duoc, dat toi
gallon	galong 1gl = 4, 54 lit o anh, 3, 78 lit o my
gamble	danh bac; cuoc danh bac
gambling	tro co bac
game	tro choi
gap	deo, lo hong, ke ho; cho trong
garage	nha de o to
garbage	long, ruot (thu)
garden	vuon
gas	khi, hoi dot
gasoline	dau lua, dau hoa, xang
gate	cong
gather	tap hop; hai, luom, thu thap
gear	co cau, thiet bi, dung cu
general	chung, chung chung; tong
generally	noi chung, dai the. in general: noi chung, dai khai
generate	sinh, de ra
generation	su sinh ra, su phat sinh ra; the he doi
generous	rong luong, khoan hong, hao phong
generously	rong luong, hao phong
gentle	hien lanh, diu dang, nhe nhang
gentleman	nguoi quy phai, nguoi thuong luu
gently	nhe nhang, em ai, diu dang
genuine	thanh that, chan that; xac thuc
genuinely	thanh that, chan that
geography	dia ly, khoa dia ly
get	duoc, co duoc. get on leo, treo len. get off: ra khoi, thoat khoi
giant	nguoi khong lo, nguoi phi thuong khong lo, phi thuong
gift	qua tang
girl	con gai
girlfriend	ban gai, nguoi yeu
give	cho, bieu, tang. give sth away cho phat. give sth out: chia, phan phoi give (sth) up bo, tu bo
glad	vui long, sung suong
glass	kinh, thuy tinh, cai coc, ly
glasses	kinh deo mat
global	toan cau, toan the, toan bo
glove	bao tay, gang tay
glue	keo, ho; gan lai, dan bang keo, ho
go	di. go down: di xuong. go up: di len. be going to sap sua, co y dinh
goal	muc dich, ban thang, khung thanh
god	than, chua
gold	vang; bang vang
good	tot, hay, tuyet; dieu tot, dieu thien. good at: tien bo o. good for: co loi cho
goodbye	tam biet; loi chao tam biet
goods	cua cai, tai san, hang hoa
govern	cai tri, thong tri, cam quyen
government	chinh phu, noi cac; su cai tri
governor	thu linh, chu; ke thong tri
grab	tum lay, vo, chop lay
grade	diem, diem so; phan loai, xep loai
gradual	dan dan, tung buoc mot
gradually	dan dan, tu tu
grain	thoc lua, hat, hot; tinh chat, ban chat
gram	dau xanh
grammar	van pham
grand	rong lon, vi dai
grandchild	chau (cua ong ba)
granddaughter	chau gai
grandfather	ong
grandmother	ba
grandparent	ong ba
grandson	chau trai
grant	cho, ban, cap; su cho, su ban, su cap
grass	co; bai co, dong co
grateful	biet on, de chiu, khoan khoai
grave	mo, dau huyen; trang nghiem, nghiem trong
gray	xam, hoa ram (toc)
great	to, lon, vi dai
greatly	rat, lam; cao thuong, cao ca
green	xanh la cay
grey	xam, hoa ram (toc)
groceries	hang tap hoa
grocery	cua hang tap pham
ground	mat dat, dat, bai dat
group	nhom
grow	moc, moc len. grow up lon len, truong thanh
growth	su lon len, su phat trien
guarantee	su bao hanh, bao lanh, nguoi bao lanh; cam doan, bao dam
guard	cai chan, nguoi bao ve; bao ve, gac, canh giu
guess	doan, phong doan; su doan, su uoc chung
guest	khach, khach moi
guide	dieu chi dan, nguoi huong dan; dan duong, chi duong
guilty	co toi, pham toi, toi loi
gun	sung
guy	bu nhin, anh chang, ga
habit	thoi quen, tap quan
hair	toc
hairdresser	tho lam toc
half	mot nua, phan chia doi, nua gio; nua
hall	dai sanh, toa (thi chinh), hoi truong
hammer	bua
hand	tay, ban tay; trao tay, truyen cho
handle	cam, so mo; tay cam, moc quai
hang	treo, mac
happen	xay ra, xay den
happily	sung suong, hanh phuc
happiness	su sung suong, hanh phuc
happy	vui suong, hanh phuc
hard	cung, ran, ha khac; het suc co gang, tich cuc
hardly	khac nghiet, nghiem khac, tan te, kho khan
harm	thiet hai, ton hao; lam hai, gay thiet hai
harmful	gay tai hai, co hai
harmless	khong co hai
hat	cai mu
hate	ghet; long cam ghet, thu han
hatred	long cam thi, su cam ghet
have	co
he	no, anh ay, ong ay
head	cai dau (nguoi, thu); chi huy, lanh dai, dan dau
headache	chung nhuc dau
heal	chua khoi, lam lanh
health	suc khoe, the chat, su lanh manh
healthy	khoe manh, lanh manh
hear	nghe
hearing	su nghe, thinh giac
heart	tim, trai tim
heat	hoi nong, suc nong
heating	su dot nong, su lam nong
heaven	thien duong
heavily	nang, nang ne
heavy	nang, nang ne
heel	got chan
height	chieu cao, do cao; dinh, diem cao
hell	dia nguc
hello	chao, xin chao; loi chao
help	giup do; su giup do
helpful	co ich; giup do
hence	sau day, ke tu day; do do, vi the
her	no, chi ay, co ay, ba ay
here	day, o day
hero	nguoi anh hung
hers	cai cua no, cai cua co ay, cai cua chi ay, cai cua ba ay
herself	chinh no, chinh co ta, chinh chi ta chinh ba ta
hesitate	ngap ngung, do du
hi	xin chao
hide	tron, an nap; che giau
high	cao, o muc do cao
highlight	lam noi bat, neu bat; cho noi bat nhat, dep, sang nhat
highly	tot, cao; het suc, o muc do cao
highway	duong quoc lo
hill	doi
him	no, han, ong ay, anh ay
himself	chinh no, chinh han, chinh ong ta, chinh anh ta
hip	hong
hire	thue, cho thue (nha...); su thue, su cho thue
his	cua no, cua han, cua ong ay, cua anh ay; cai cua no, cai cua han, cai cua ong ay, cai cua anh ay
historical	lich su, thuoc lich su
history	lich su, su hoc
hit	danh, dam, nem trung; don, cu dam
hobby	so thich rieng
hold	cam, nam, giu; su cam, su nam giu
hole	lo, lo trong; hang
holiday	ngay le, ngay nghi
hollow	rong, trong rong
holy	linh thieng; sung dao
home	nha; o tai nha, nuoc minh
homework	bai tap ve nha (hoc sinh), cong viec lam o nha
honest	luong thien, trung thuc, chan that
honestly	luong thien, trung thuc, chan that
honour	danh du, thanh danh, long kinh trong. in honour/honor of: de to long ton kinh, tran trong doi voi
hook	cai moc; ban le; luoi cau
hope	hy vong; nguon hy vong
horizontal	(thuoc) chan troi, o chan troi; ngang, nam ngang (truc hoanh)
horn	sung (trau, bo...)
horror	dieu kinh khung, su ghe ron
horse	ngua
hospital	benh vien, nha thuong
host	chu nha, chu tiec; dan (c.trinh), >dang cai to >chuc (hoi nghi....)
hot	nong, nong buc
hotel	khach san
hour	gio
house	nha, can nha, toan nha
household	ho, gia dinh; (thuoc) gia dinh
housing	noi an chon o
how	the nao, nhu the nao, lam sao, ra >sao
however	tuy nhien, tuy vay, du the nao
huge	to lon, khong lo
human	(thuoc) con nguoi, loai nguoi
humorous	hai huoc, hom hinh
humour	su hai huoc, su hom hinh
hungry	doi
hunt	san, di san
hunting	su di san
hurry	su voi vang, su gap rut. in a hurry: >voi vang, hoi ha, gap rut
hurt	lam bi thuong, gay thiet hai
husband	nguoi chong
ice	bang, nuoc da
idea	y tuong, quan niem
ideal	(thuoc) quan niem, tu tuong; >ly >tuong
ideally	ly tuong, dung nhu ly tuong
identify	nhan biet, nhan ra, nhan dang
identity	ca tinh, net nhan dang; tinh dong >nhat, giong het
if	neu, neu nhu
ignore	phot lo, to ra khong biet den
ill	om
illegal	trai luat, bat hop phap
illegally	trai luat, bat hop phap
illness	su dau yeu, om, benh tat
illustrate	minh hoa, lam ro y
image	anh, hinh anh
imaginary	tuong tuong, ao
imagination	tri tuong tuong, su tuong tuong
imagine	tuong tuong, hinh dung; tuong >rang, cho rang
immediate	lap tuc, >tuc thi
immediately	ngay lap tuc
immoral	trai dao duc, luan ly; xau xa
impact	su va cham, su tac dong, anh >huong
impatient	thieu kien nhan, nong voi
impatiently	nong long, sot ruot
implication	su loi keo, su lien can, dieu goi y
imply	ngu y, bao ham
import	import su nhap, su nhap khau; >nhap, nhap khau
importance	su quan trong, tam quan trong
important	quan trong, he trong
importantly	quan trong, trong yeu
impose	danh (thue...), bat ganh vac; danh >trao, loi dung
impossible	khong the lam duoc, khong the >xay ra
impress	ghi, khac, in sau vao; gay an >tuong, lam cam dong
impressed	duoc ghi, khac, in sau vao
impression	an tuong, cam giac; su in, dong >dau
impressive	gay an tuong manh; hung vi, oai >ve
improve	cai thien, cai tien, mo mang
improvement	su cai thien, su cai tien, su mo >mang
in	o, tai, trong; vao
inability	su bat luc, bat tai
inch	inso (don vi do chieu dai anh >bang 2, 54 cm)
incident	viec xay ra, >viec co lien quan
include	bao gom, tinh ca
including	bao gom, ke ca
income	loi tuc, thu nhap
increase	tang, tang them; su tang, su tang >them
increasingly	tang >them
indeed	that vay, qua that
independence	su doc lap, nen doc lap
independent	doc lap
independently	doc lap
index	chi so, su bieu thi
indicate	chi, cho biet; bieu thi, trinh bay >ngan gon
indication	su chi, su bieu thi, su bieu lo
indirect	gian tiep
indirectly	gian tiep
individual	rieng, rieng biet; ca nhan
indoor	trong nha
indoors	o trong nha
industrial	(thuoc) cong nghiep, ky nghe
industry	cong nghiep, ky nghe
inevitable	khong the tranh duoc, chac chan >xay ra; van thuong thay, nghe
inevitably	chac chan, chac han
infect	nhiem, tiem nhiem, dau doc, lan truyen
infected	bi nhiem, bi dau doc
infection	su nhiem, su dau doc
infectious	lay, nhiem
influence	su anh huong, su tac dung; anh huong, tac dong
inform	bao cho biet, cung cap tin tuc
informal	khong chinh thuc, khong nghi thuc
information	tin tuc, tai lieu, kien thuc
ingredient	phan hop thanh, thanh phan
initial	ban dau, luc dau; chu dau (cua 1 ten goi)
initially	vao luc ban dau, ban dau
initiative	buoc dau, su khoi dau
injure	lam ton thuong, lam hai, xuc pham
injured	bi ton thuong, bi xuc pham
injury	su lam ton thuong, lam hai; dieu hai, dieu ton hai
ink	muc
inner	o trong, noi bo; than can
innocent	vo toi, trong trang, ngay tho
insect	sau bo, con trung
insert	chen vao, long vao
inside	mat trong, phia, phan trong; o trong, noi bo
insist	cu nhat dinh, cu khang khang
install	dat (he thong may moc, thiet bi...)
instance	thi di, vi du; truong hop ca biet. for instance vi du chang han
instead	de thay the. instead of thay cho
institute	vien, hoc vien
institution	su thanh lap, lap; co quan, tru so
instruction	su day, tai lieu cung cap
instrument	dung cu am nhac khi
insult	lang ma, xi nhuc; loi lang ma, su xi nhuc
insulting	lang ma, xi nhuc
insurance	su bao hiem
intelligence	su hieu biet, tri thong minh
intelligent	thong minh, sang tri
intend	y dinh, co y dinh
intended	co y dinh, co dung y
intention	y dinh, muc dich
interest	su thich thu, su quan tam, chu y; lam quan tam, lam chu y
interested	co chu y
interesting	lam thich thu, lam quan tam, lam chu y
interior	phan trong, phia trong; o trong, o phia trong
internal	o trong, ben trong, noi dia
international	quoc te
internet	lien mang
interpret	giai thich
interpretation	su giai thich
interrupt	lam gian doan, ngat loi
interruption	su gian doan, su ngat loi
interval	khoang (khoang thoi gian), khoang cach
interview	cuoc phong van, su gap mat; phong van, noi chuyen rieng
into	vao, vao trong
introduce	gioi thieu
introduction	su gioi thieu, loi gioi thieu
invent	phat minh, sang che
invention	su phat minh, su sang che
invest	dau tu
investigate	dieu tra, nghien cuu
investigation	su dieu tra, nghien cuu
investment	su dau tu, von dau tu
invitation	loi moi, su moi
invite	moi
involve	bao gom, bao ham; thu hut, don tam tri. involved in de het tam tri vao
involvement	su gom, su bao ham; su de, don het tam tri vao
iron	sat; boc sat
irritate	lam phat cau, choc tuc
irritated	tuc gian, cau tiet
irritating	lam phat cau, choc tuc
island	hon dao
issue	su phat ra, su phat sinh; phat hanh, dua ra
it	cai do, dieu do, con vat do
item	tin tuc; khoa(n)., mo(n).., tiet muc
its	cua cai do, cua dieu do, cua con vat do; cai cua dieu do, cai cua con vat do
itself	chinh cai do, chinh dieu do, chinh con vat do
jacket	ao vet
jam	mut, su mac ket, su ket (may...)
january	thang gieng
jealous	ghen,, ghen ti
jeans	quan bo, quan zin
jelly	thach
jewellery	nu trang, kim hoan
job	viec, viec lam
join	gia nhap, tham gia; noi, chap, ghep
joint	chung (giua 2 nguoi hoac hon); cho noi, dau noi
jointly	cung nhau, cung chung
joke	tro cuoi, loi noi dua; noi dua, gieu cot
journalist	nha bao
journey	cuoc hanh trinh (duong bo); quang duong, chang duong di
joy	niem vui, su vui mung
judge	xet xu, phan xu; quan toa, tham phan
judgement	su xet xu
juice	nuoc ep (rau, cu, qua)
july	thang 7
jump	nhay; su nhay, buoc nhay
june	thang 6
junior	tre hon, it tuoi hon; nguoi it tuoi hon
just	dung, vua du; vua moi, chi
justice	su cong bang
justified	hop ly, duoc chung minh la dung
justify	bao chua, bien ho
keen	sac, ben. keen on: say me, ua thich
keep	giu, giu lai
key	chia khoa, khoa, thuoc (khoa)
keyboard	ban phim
kick	da; cu da
kid	con de non
kill	giet, tieu diet
killing	su giet choc, su tan sat
kilogram	kilogam
kilometre	kilomet
kind	loai, giong; tu te, co long tot
kindly	tu te, tot bung
kindness	su tu te, long tot
king	vua, quoc vuong
kiss	hon, cai hon
kitchen	bep
knee	dau goi
knife	con dao
knit	dan, theu
knitted	duoc dan, duoc theu
knitting	viec dan; hang det kim
knock	danh, dap; cu danh
knot	cai no; diem nut, diem trung tam
know	biet
knowledge	su hieu biet, tri thuc
label	nhan, mac; dan nhan, ghi mac
laboratory	phong thi nghiem
labour	lao dong; cong viec
lack	su thieu; thieu
lacking	ngu dan, ngay ngo
lady	nguoi yeu, vo, quy ba, tieu thu
lake	ho
lamp	den
land	dat, dat canh tac, dat dai
landscape	phong canh
lane	duong nho (lang, hem pho)
language	ngon ngu
large	rong, lon, to
largely	phong phu, o muc do lon
last	lan cuoi, sau cung; nguoi cuoi cung; cuoi cung, rot het; keo dai
late	tre, muon
later	cham hon
latest	muon nhat, cham nhat, gan day nhat
latter	sau cung, gan day, moi day
laugh	cuoi; tieng cuoi
launch	ha thuy (tau); khai truong; su ha thuy, buoi gioi thieu san pham
law	luat
lawyer	luat su
lay	xep, dat, bo tri
layer	lop
lazy	luoi bieng
lead	lanh dao, dan dat; su lanh dao, su huong dan
leader	nguoi lanh dao, lanh tu
leading	lanh dao, dan dau
leaf	la cay, la (vang...)
league	lien minh, lien hoan
lean	nghieng, dua, y vao
learn	hoc, nghien cuu
least	toi thieu; it nhat. at least: it ra, it nhat, chi it
leather	da thuoc
leave	bo di, roi di, de lai. leave out bo quen, bo sot
lecture	bai dien thuyet, bai thuyet trinh, bai noi chuyen
left	ben trai; ve phia trai
leg	chan (nguoi, thu, ba(n)..)
legal	hop phap
legally	hop phap
lemon	qua chanh
lend	cho vay, cho muon
length	chieu dai, do dai
less	nho be, it hon; so luong it hon
lesson	bai hoc
let	cho phep, de cho
letter	thu; chu cai, mau tu
level	trinh do, cap, vi tri; bang, ngang bang
library	thu vien
licence	bang, chung chi, bang cu nhan; su cho phep
license	cap chung chi, cap bang, cho phep
lid	nap, vung (xoong, noi..); mi mat (eyelid)
lie	noi doi; loi noi doi, su doi tra
life	doi, su song
lift	gio len, nhac len; su nang, su nhac len
light	anh sang; nhe, nhe nhang; dot, thap sang
lightly	nhe nhang
like	giong nhu; thich; nhu
likely	co the dung, co the xay ra, co kha nang; co the, chac vay
limit	gioi han, ranh gioi; gioi han, han che
limited	han che, co gioi han
line	day, duong, tuyen
link	mat xich, moi lien lac; lien ket, ket noi
lip	moi
liquid	chat long; long, em ai, du duong, khong vung
list	danh sach; ghi vao danh sach
listen	nghe, lang nghe
literature	van chuong, van hoc
litre	lit
little	nho, be, chut it; khong nhieu; mot chut
live	song, hoat dong
lively	song, sinh dong
living	song, dang song
load	ganh nang, vat nang; chat, cho
loan	su vay muon
local	dia phuong, bo phan, cuc bo
locally	co tinh chat dia phuong, cuc bo
locate	xac dinh vi tri, dinh vi
located	dinh vi
location	vi tri, su dinh vi
lock	khoa; khoa
logic	lo gic
logical	hop ly, hop logic
lonely	co don, bo vo
long	dai, xa; lau
look	nhin; cai nhin
loose	long, khong chat
loosely	long leo
lord	chua, vua
lorry	xe tai
lose	mat, thua, lac
loss	su mat, su thua
lost	thua, mat
lot	so luong lon; rat nhieu
loud	to, inh oi, am i; to, lon (noi)
loudly	am i, inh oi
love	tinh yeu, long yeu thuong; yeu, thich
lovely	dep, xinh xan, co duyen
lover	nguoi yeu, nguoi tinh
low	thap, be, lun
loyal	trung thanh, trung kien
luck	may man, van may
lucky	gap may, gap may man, hanh phuc
luggage	hanh ly
lump	cuc, tang, mieng; cai buou
lunch	bua an trua
lung	phoi
machine	may, may moc
machinery	may moc, thiet bi
mad	dien, mat tri; buc dien nguoi
magazine	tap chi
magic	ma thuat, ao thuat; (thuoc) ma thuat, ao thuat
mail	thu tu, buu kien; gui qua buu dien
main	chinh, chu yeu, trong yeu nhat
mainly	chinh, chu yeu, phan lon
maintain	giu gin, duy tri, bao ve
major	lon, nhieu hon, trong dai, chu yeu
majority	phan lon, da so, uu the
make	lam, che tao; su che tao. make sth up: lam thanh, cau thanh, gop thanh
male	trai, trong, duc; con trai, dan ong, con trong, duc
mall	bua
man	con nguoi; dan ong
manage	quan ly, trong nom, dieu khien
management	su quan ly, su trong nom, su dieu khien
manager	nguoi quan ly, giam doc
manner	cach, loi, kieu; dang, ve, thai do
manufacture	san xuat, che tao
manufacturer	nguoi che tao, nguoi san xuat
manufacturing	su san xuat, su che tao
many	nhieu
map	ban do
march	thang ba
mark	dau, nhan, nhan mac; danh dau, ghi dau
market	cho, thi truong
marketing	ma-ket-tinh
marriage	su cuoi xin, su ket hon, le cuoi
married	cuoi, ket hon
marry	cuoi (vo), lay (chong)
mass	khoi, khoi luong; quan chung, dai chung
massive	to lon, do so
master	chu, chu nhan, thay giao, thac si
match	tran thi dau, doi thu, dich thu; doi choi, sanh duoc
matching	tinh dich thu, thi dau
mate	ban, ban nghe; giao phoi
material	nguyen vat lieu; vat chat, huu hinh
mathematics	toan hoc, mon toan
matter	chat, vat chat; co y nghia, co tinh chat quan trong
maximum	cuc do, toi da; tri so cuc dai, luong cuc dai, cuc do
may	thang 5, co the, co le
maybe	co the, co le
mayor	thi truong
me	toi, tao, to
meal	bua an
mean	nghia, co nghia la
meaning	y, y nghia
means	cua cai, tai san, phuong tien. by means: of bang phuong tien
meanwhile	trong luc do, trong luc ay
measure	do, do luong; su do luong, don vi do luong
measurement	su do luong, phep do
meat	thit
media	phuong tien truyen thong dai chung
medical	(thuoc) y hoc
medicine	y hoc, y khoa; thuoc
medium	trung binh, trung, vua; su trung gian, su moi gioi
meet	gap, gap go
meeting	cuoc mit tinh, cuoc bieu tinh
melt	tan ra, chay ra; lam tan chay ra
member	thanh vien, hoi vien
membership	tu cach hoi vien, dia vi hoi vien
memory	bo nho, tri nho, ki niem. in memory of: su tuong nho
mental	(thuoc) tri tue, tri oc; mat tri
mentally	ve mat tinh than
mention	ke ra, noi den, de cap
menu	thuc don
mere	chi la
merely	chi, don thuan
mess	tinh trang bua bon, tinh trang lon xon; nguoi nhech nhac, ban thiu
message	tin nhan, thu tin, dien thong bao, thong diep
metal	kim loai
method	phuong phap, cach thuc
metre	met
midday	trua, buoi trua
middle	giua, o giua
midnight	nua dem, 12h dem
might	qk. may co the, co le
mild	nhe, em diu, on hoa
mile	dam (do luong)
military	(thuoc) quan doi, quan su
milk	sua
milligram	mi-li-gam
mind	tam tri, tinh than, tri tue; chu y, de y, cham soc, quan tam
mine	cua toi
mineral	cong nhan, tho mo; khoang
minimum	toi thieu; so luong toi thieu, muc toi thieu
minister	bo truong
ministry	bo
minor	nho hon, thu yeu, khong quan trong
minority	phan it, thieu so
minute	phut
mirror	guong
miss	lo, truot; su truot, su thieu vang
missing	vang, thieu, that lac
mistake	loi, sai lam, loi lam; pham loi, pham sai lam
mistaken	sai lam, hieu lam
mix	pha, tron lan; su pha tron
mixed	lan lon, pha tron
mixture	su pha tron, su hon hop
mobile	chuyen dong, di dong
model	mau, kieu mau
modern	hien dai, tan tien
moment	choc, lat
monday	thu 2
money	tien
monitor	lop truong, man hinh may tinh; nghe, ghi phat thanh, giam sat
month	thang
mood	loi, thuc, dieu, tam trang, tinh khi
moon	mat trang
moral	(thuoc) dao duc, luan ly, pham hanh; co dao duc
morally	co dao duc
more	hon, nhieu hon
moreover	hon nua, ngoai ra, va lai
morning	buoi sang
most	lon nhat, nhieu nhat; nhat, hon ca
mostly	hau het, chu yeu la
mother	me
motion	su chuyen dong, su di dong
motor	dong co mo to
motorcycle	xe mo to
mount	leo, treo; nui
mountain	nui
mouse	chuot
mouth	mieng
move	di chuyen, chuyen dong; su di chuyen, su chuyen dong
movement	su chuyen dong, su hoat dong; cu dong, dong tac
movie	phim xi ne
moving	dong, hoat dong
mr	ong, ngai
mrs	co
ms	ba, co
much	nhieu, lam
mud	bun
multiply	nhan len, lam tang len nhieu lan; sinh soi nay no
mum	me
murder	toi giet nguoi, toi am sat; giet nguoi, am sat
muscle	co, bap thit
museum	bao tang
music	nhac, am nhac
musical	(thuoc) nhac, am nhac; du duong, em ai
musician	nhac si
must	phai, can, nen lam
my	cua toi
myself	tu toi, chinh toi
mysterious	than bi, huyen bi, kho hieu
mystery	dieu huyen bi, dieu than bi
nail	mong (tay, chan) mong vuot
naked	tran, khoa than, tro trui
name	ten; dat ten, goi ten
narrow	hep, chat hep
nation	dan toc, quoc gia
national	(thuoc) quoc gia, dan toc
natural	(thuoc) tu nhien, thien nhien
naturally	von, tu nhien, duong nhien
nature	tu nhien, thien nhien
navy	hai quan
near	gan, can; o gan
nearby	gan
nearly	gan, sap, suyt
neat	sach, ngan nap; ranh mach
neatly	gon gang, ngan nap
necessarily	tat yeu, nhat thiet
necessary	can, can thiet, thiet yeu
neck	co
need	can, doi hoi; su can
needle	cai kim, mui nhon
negative	phu dinh
neighbour	hang xom
neighbourhood	hang xom, lang gieng
neither	khong nay ma cung khong kia
nephew	chau trai (con anh, chi, em)
nerve	khi luc, than kinh, can dam
nervous	hoang so, de bi kich thich, hay lo lang
nervously	bon chon, lo lang
nest	to, o; lam to
net	luoi, mang
network	mang luoi, he thong
never	khong bao gio, khong khi nao
nevertheless	tuy nhien, tuy the ma
new	moi, moi me, moi la
newly	moi
news	tin, tin tuc
newspaper	bao
next	sat, gan, ben canh; lan sau, tiep nua. next to: gan
nice	dep, thu vi, de chiu
nicely	thu vi, de chiu
niece	chau gai
night	dem, toi
no	khong
nobody	khong ai, khong nguoi nao
noise	tieng on, su huyen nao
noisily	on ao, huyen nao
noisy	on ao, huyen nao
none	khong ai, khong nguoi, vat gi
nonsense	loi noi vo ly, vo nghia
nor	cung khong
normal	thuong, binh thuong; tinh trang binh thuong
normally	thong thuong, nhu thuong le
north	phia bac, phuong bac
northern	bac
nose	mui
not	khong
note	loi ghi, loi ghi chep; ghi chu, ghi chep
nothing	khong gi, khong cai gi
notice	thong bao, yet thi; chu y, de y, nhan biet. take notice of chu y
noticeable	dang chu y, dang de y
novel	tieu thuyet, truyen
november	thang 11
now	bay gio, hien gio, hien nay
nowhere	khong noi nao, khong o dau
nuclear	(thuoc) hat nhan
number	so
nurse	y ta
nut	qua hach; dau
o clock	dung gio
obey	vang loi, tuan theo, tuan lenh
object	vat, vat the, doi tuong; phan doi,chong lai
objective	muc tieu, muc dich; (thuoc) muc tieu, khach quan
observation	su quan sat, su theo doi
observe	quan sat, theo doi
obtain	dat duoc, gianh duoc
obvious	ro rang, ranh mach, hien nhien
obviously	mot cach ro rang, co the thay duoc
occasion	dip, co hoi
occasionally	thinh thoang, doi khi
occupied	dang su dung, day (nguoi)
occupy	giu, chiem linh, chiem giu
occur	xay ra, xay den, xuat hien
ocean	dai duong
october	thang 10
odd	ky quac, ky cuc, le (so)
oddly	ky quac, ky cuc, le (so)
of	cua
off	tat; khoi, cach, roi
offence	su vi pham, su pham toi
offend	xuc pham, lam buc minh, lam kho chiu
offensive	su tan cong, cuoc tan cong, si nhuc
offer	bieu, tang, cho; su tra gia
office	co quan, van phong, bo
officer	vien chuc, canh sat, si quan
official	(thuoc) chinh quyen, van phong; vien chuc, cong chuc
officially	mot cach trinh trong, mot cach chinh thuc
often	thuong, hay, luon
oh	chao, oi chao, cha, nay..
oil	dau
old	gia
old-fashioned	loi thoi
on	tren, o tren; tiep tuc, tiep dien
once	mot lan; khi ma, ngay khi, mot khi
onion	cu hanh
only	chi co 1, duy nhat; chi, moi
onto	ve phia tren, len tren
open	mo, ngo; mo, bat dau, khai mac
opening	khe ho, lo; su bat dau, su khai mac, le khanh thanh
openly	cong khai, thang than
operate	hoat dong, dieu khien
operation	su hoat dong, qua trinh hoat dong
opinion	y kien, quan diem
opponent	dich thu, doi thu, ke thu
opportunity	co hoi, thoi co
oppose	doi khang, doi choi, doi lap; chong doi, phan doi
opposing	tinh doi khang, doi choi
opposite	doi nhau, nguoc nhau; truoc mat, doi dien; dieu trai nguoc
opposition	su doi lap, su doi nhau; su chong lai, su phan doi; phe doi lap
option	su lua chon
orange	qua cam; co mau da cam
order	thu, bac; ra lenh. in order to hop le
ordinary	thuong, thong thuong
organ	dan ooc gan
organization	to chuc, co quan; su to chuc
organize	to chuc, thiet lap
organized	co trat tu, ngan nap, duoc sap xep, duoc to chuc
origin	goc, nguon goc, can nguyen
original	(thuoc) goc, nguon goc, can nguyen; nguyen ban
originally	mot cach sang tao, moi me, doc dao; khoi dau, dau tien
other	khac
otherwise	khac, cach khac; neu khong thi...; mat khac
our	cua chung ta, thuoc chung ta, cua chung toi, cua chung minh
ours	cua chung ta, thuoc chung ta, cua chung toi, cua chung minh
ourselves	ban than chung ta, ban than chung toi, ban than chung minh; tu chung minh
out	ngoai, o ngoai, ra ngoai
outdoor	ngoai troi, o ngoai
outdoors	o ngoai troi, o ngoai nha
outer	o phia ngoai, o xa hon
outline	ve, phac tao; duong net, hinh dang, net ngoai
output	su san xuat; san pham, san luong
outside	be ngoai, ben ngoai; o ngoai; ngoai
outstanding	noi bat, dang chu y; con ton lai
oven	lo (nuong)
over	ben tren, vuot qua; len, len tren
overall	toan bo, toan the; tat ca, bao gom
overcome	thang, chien thang, khac phuc, danh bai (kho khan)
owe	no, ham on; co duoc (cai gi)
own	cua chinh minh, tu minh; nhan, nhin nhan
owner	nguoi chu, chu nhan
pace	buoc chan, buoc
pack	goi, boc; bo, goi
package	goi do, buu kien; dong goi, dong kien
packaging	bao bi
packet	goi nho
page	trang (sach)
pain	su dau don, su dau kho
painful	dau don, dau kho
paint	son, voi mau; son, quet son
painter	hoa si
painting	su son; buc hoa, buc tranh
pair	doi, cap
palace	cung dien, lau dai
pale	tai, nhot
pan	xoong, chao
panel	van o (cua, tuong), pa no
pants	quan lot, quan dui dai
paper	giay
parallel	song song, tuong duong
parent	cha, me
park	cong vien, vuon hoa; khoanh vung thanh cong vien
parliament	nghi vien, quoc hoi
part	phan, bo phan
particular	rieng biet, ca biet
particularly	mot cach dac biet, ca biet, rieng biet
partly	den chung muc nao do, phan nao do
partner	doi tac, cong su
partnership	su chung phan, su cong tac
party	tiec, buoi lien hoan; dang
pass	qua, vuot qua, ngang qua
passage	su di qua, su troi qua; hanh lang
passenger	hanh khach
passing	su di qua, su troi qua; thoang qua ngan ngui
passport	ho chieu
past	qua khu, di vang; qua, qua
path	duong mon; huong di
patience	tinh kien nhan, nhan nai, kien tri, su chiu dung
patient	benh nhan; kien nhan, nhan nai, ben chi
pattern	mau, khuon mau
pause	tam nghi, dung; su tam nghi, su tam ngung
pay	tra, thanh toan, nop; tien luong
payment	su tra tien, so tien tra, tien boi thuong
peace	hoa binh, su hoa thuan
peaceful	hoa binh, thai binh, yen tinh
peak	luoi trai; dinh, chop
pen	but
pence	dong xu
pencil	but chi
penny	dong xu
pension	tien tro cap, luong huu
people	dan toc, dong giong; nguoi
pepper	hat tieu, cay ot
per	cho moi
perfect	hoan hao
perfectly	mot cach hoan hao
perform	bieu dien; lam, thuc hien
performance	su lam, su thuc hien, su thi hanh, su bieu dien
performer	nguoi bieu dien, nguoi trinh dien
perhaps	co the, co le
period	ky, thoi ky, thoi gian; thoi dai
permanent	lau dai, vinh cuu, thuong xuyen
permanently	cach thuong xuyen, vinh cuu
permission	su cho phep, giay phep
permit	cho phep, cho co hoi
person	con nguoi, nguoi
personal	ca nhan, tu, rieng tu
personality	nhan cach, tinh cach; nhan pham, ca tinh
personally	dich than, ban than, ve phan toi, doi voi toi
persuade	thuyet phuc
pet	con nong gian; vat cung, nguoi duoc yeu thich
petrol	xang dau
phase	tuan trang; giai doan, thoi ky
philosophy	triet hoc, triet ly
photocopy	ban sao chup; sao chup
photograph	anh, buc anh; chup anh
photographer	tho chup anh, nha nhiep anh
photography	thuat chup anh, nghe nhiep anh
phrase	cau; thanh ngu, cum tu
physical	vat chat; (thuoc) co the, than the
physically	ve than the, theo luat tu nhien
physics	vat ly hoc
piano	dan piano, duong cam
pick	cuoc (dat); dao, khoet (lo). pick sth up cuoc, vo, xe
picture	buc ve, buc hoa
piece	manh, mau; dong tien
pig	con lon
pile	coc, chong, dong, pin; dong coc, chat chong
pill	vien thuoc
pilot	phi cong
pin	dinh ghim; ghim., kep
pink	mau hong; hoa cam chuong, tinh trang tot, hoan hao
pint	panh (don vi (do luong) o anh bang 0, 58 lit; o my bang 0, 473 lit); panh, lit (bia, sua) a pint of beer + mot panh bia
pipe	ong dan (khi, nuoc...)
pitch	san (choi cac mon the thao); dau hac in
pity	long thuong hai, dieu dang tiec, dang thuong
place	noi, dia diem; quang truong. take place: xay ra, duoc cu hanh, duoc to chuc
plain	ngay thang, don gian, chat phac
plan	ban do, ke hoach; ve ban do, lap ke hoach, du kien
plane	mat phang, mat bang, may bay
planet	hanh tinh
planning	su lap ke hoach, su quy hoach
plant	thuc vat, su moc len; trong, gieo
plastic	chat deo, lam bang chat deo
plate	ban, tam kim loai
platform	nen, buc, be; them, san ga
play	choi, danh; su vui choi, tro choi, tran dau
player	nguoi choi 1 tro choi nao do (nhac cu)
pleasant	vui ve, de thuong; diu dang, than mat
pleasantly	vui ve, de thuong; than mat
please	lam vui long, vua long, mong... vui long, xin moi
pleased	hai long
pleasing	mang lai niem vui thich; de chiu
pleasure	niem vui thich, dieu thich thu, dieu thu vi; y muon, y thich
plenty	nhieu (s.k.luong); chi su thua; su sung tuc, su p.phu
plot	manh dat nho, so do, do thi, do an; ve so do, dung do an
plug	nut (thung, chau, bo(n)..), cai phic cam
plus	cong voi (so, nguoi...); dau cong; cong, them vao
pocket	tui (quan ao, trong xe hoi), tui tien
poem	bai tho
poetry	thi ca; chat tho
point	mui nhon, diem; vot, lam nhon, cham (cau..)
pointed	nhon, co dau nhon
poison	chat doc, thuoc doc; danh thuoc doc, tam thuoc doc
poisonous	doc, co chat doc, gay chet, benh
pole	nguoi ba lan; cuc (nam cham, trai dat...)
police	canh sat, cong an
policy	chinh sach
polish	nuoc bong, nuoc lang; danh bong, lam cho lang
polite	le phep, lich su
politely	le phep, lich su
political	ve chinh tri, ve chinh phu, co tinh chinh tri
politically	ve mat chinh tri; khon ngoan, than trong; sao quyet
politician	nha chinh tri, chinh khach
politics	hoat dong chinh tri, doi song chinh tri, quan diem chinh tri
pollution	su o nhiem
pool	vung nuoc; be boi, ho boi
poor	ngheo
pop	tiep bop, phong cach dan gian hien dai; no bop
popular	co tinh dai chung, (thuoc) nhan dan; duoc nhieu nguoi ua chuong
population	dan cu, dan so; mat do dan so
port	cang
pose	dua ra, de ra, dat; su dat, de ra
position	vi tri, cho
positive	khang dinh, xac thuc, ro rang, tich cuc, lac quan
possess	co, chiem huu
possession	quyen so huu, vat so huu
possibility	kha nang, trien vong
possible	co the, co the thuc hien
possibly	co le, co the, co the chap nhan duoc
post	thu, buu kien; gui thu
post office	buu dien
pot	can, binh, lo...
potato	khoai tay
potential	tiem nang; kha nang, tiem luc
potentially	tiem nang, tiem an
pound	pao - don vi do luong
pour	rot, do, gioi
powder	bot, bui
power	kha nang, tai nang, nang luc; suc manh, noi luc; quyen luc
powerful	hung manh, hung cuong
practical	thuc hanh; thuc te
practically	ve mat thuc hanh; thuc te
practice	thuc hanh, thuc tien
practise	thuc hanh, tap luyen
praise	su ca ngoi, su tan duong, long ton kinh, ton tho; khen ngoi, tan duong
prayer	su cau nguyen
precise	ro rang, chinh xac; ti mi, ky tinh
precisely	dung, chinh xac, can than
predict	bao truoc, tien doan, du bao
prefer	thich hon
preference	su thich hon, su ua hon; cai duoc ua thich hon
pregnant	mang thai; giau tri tuong tuong, sang tao
premises	biet thu
preparation	su sua soan, su chuan bi
prepare	sua soan, chuan bi
prepared	da duoc chuan bi
presence	su hien dien, su co mat; nguoi, vat hien dien
present	co mat, hien dien; hien nay, hien thoi; bay to, gioi thieu, trinh bay
presentation	bai thuyet trinh, su trinh dien, su gioi thieu
preserve	bao quan, giu gin
president	hieu truong, chu tinh, tong thong
press	su ep, su nen, su an; ep, nen, bop, an
pressure	suc ep, ap luc, ap suat
presumably	co the duoc, co le
pretend	gia vo, gia bo, lam ra ve
pretty	kha, vua phai; xinh, xinh xan;, dep
prevent	ngan can, ngan chan, ngan ngua
previous	voi vang, hap tap; truoc (vd. ngay hom truoc), uu tien
previously	truoc, truoc day
price	gia
pride	su kieu hanh, su hanh dien; tinh kieu cang, tu phu
priest	linh muc, thay tu
primarily	truoc het, dau tien
primary	nguyen thuy, dau tien; thoi co dai, nguyen sinh; so cap, tieu hoc
prime minister	thu tuong
prince	hoan tu
princess	cong chua
principle	co ban, chu yeu; nguyen ly, nguyen tac
print	in, xuat ban; su in ra
printer	may in, tho in
printing	su in, thuat in, ky sao in
prior	truoc, uu tien
priority	su uu te, quyen uu tien
prison	nha tu
prisoner	tu nhan
private	ca nhan, rieng
privately	rieng tu, ca nhan
prize	giai, giai thuong
probable	co the, co kha nang
probably	hau nhu chac chan
problem	van de, dieu kho giai quyet
procedure	thu tuc
proceed	tien len, theo duoi, tiep dien
process	qua trinh, su tien trien, quy trinh; che bien, gia cong, xu ly
produce	san xuat, che tao
producer	nha san xuat
product	san pham
production	su san xuat, che tao
profession	nghe, nghe nghiep
professional	(thuoc) nghe, nghe nghiep; chuyen nghiep
professor	giao su, giang vien
profit	thuan loi, loi ich, loi nhuan
program	chuong trinh; len chuong trinh
programme	chuong trinh
progress	su tien toi, su tien trien; tien bo, tien trien, phat trien
project	de an, du an, ke hoach; du kien, ke hoach
promise	hua, loi hua
promote	thang chuc, thang cap
promotion	su thang chuc, su thang cap
prompt	mau le, nhanh chong; xui, giuc, nhac nho
promptly	mau le, ngay lap tuc
pronounce	tuyen bo, thong bao, phat am
pronunciation	su phat am
proof	chung, chung co, bang chung; su kiem chung
proper	dung, thich dang, thich hop
properly	mot cach dung dan, mot cach thich dang
property	tai san, cua cai; dat dai, nha cua, bat dong san
proportion	su can xung, su can doi
proposal	su de nghi, de xuat
propose	de nghi, de xuat, dua ra
prospect	vien canh, toan canh; trien vong, mong cho
protect	bao ve, che cho
protection	su bao ve, su che cho
react	tac dong tro lai, phan ung
reaction	su phan ung; su phan tac dung
read	doc
reader	nguoi doc, doc gia
reading	su doc
ready	san sang
real	thuc, thuc te, co that
realistic	hien thuc
reality	su that, thuc te, thuc tai
realize	thuc hien, thuc hanh; thay ro, hieu ro, nhan thuc ro (viec gi...)
really	thuc, thuc ra, thuc su
rear	phia sau; o dang sau, o dang sau
reason	ly do, ly le
reasonable	co ly, hop ly
reasonably	hop ly
recall	goi ve, trieu hoi; nhac lai, goi lai
receipt	cong thuc; don thuoc
receive	nhan, linh, thu
recent	gan day, moi day
recently	gan day, moi day
reception	su nhan, su tiep nhan, su don tiep
reckon	tinh, dem
recognition	su cong nhan, su thua nhan
recognize	nhan ra, nhan dien; cong nhan, thua nhan
recommend	gioi thieu, tien cu; de nghi, khuyen bao
record	ban ghi, su ghi, ban thu, su thu; thu, ghi chep
recording	su ghi, su thu am
recover	lay lai, gianh lai
red	do; mau do
reduce	giam, giam bot
reduction	su giam gia, su ha gia
reference	su tham khao, hoi y kien
reflect	phan chieu, phan hoi, phan anh
reform	cai cach, cai thien, cai tao; su cai cach, su cai thien, cai tao
refrigerator	tu lanh
refusal	su tu choi, su khuoc tu
refuse	tu choi, khuoc tu
regard	nhin, danh gia; cai nhin, su quan tam, su chu y (loi chuc tung cuoi thu)
regarding	ve, ve viec, doi voi (van de...)
region	vung, mien
regional	vung, dia phuong
register	dang ky, ghi vao so; so, so sach, may ghi
regret	dang tiec, hoi tiec; long thuong tiec, su hoi tiec
regular	thuong xuyen, deu dan
regularly	deu dan, thuong xuyen
regulation	su dieu chinh, dieu le, quy tac
reject	khong chap nhan, loai bo, bac bo
relate	ke lai, thuat lai; lien he, lien quan
related	co lien quan, co quan he voi ai, cai gi
relation	moi quan he, su lien quan, lien lac
relationship	moi quan he, moi lien lac
relative	co lien quan den; nguoi co ho, da tu quan he
relatively	co lien quan, co quan he
relax	giai tri, nghi ngoi
relaxed	thanh than, thoai mai
relaxing	lam giam, bot cang thang
release	lam nhe, bot, tha, phong thich, phat hanh; su giai thoat, thoat khoi, su tha, phong thich, su phat hanh
relevant	thich hop, co lien quan
relief	su giam nhe, su lam cho khuay khoa; su tro cap; su den bu
religion	ton giao
religious	(thuoc) ton giao
remain	con lai, van con nhu cu
remaining	con lai
remains	do thua, cai con lai
remark	su nhan xet, phe binh, su de y, chu y; nhan xet, phe binh, de y, chu y
remarkable	dang chu y, dang de y; khac thuong
remarkably	dang chu y, dang de y; khac thuong
remember	nho, nho lai
remind	nhac nho, goi nho
remote	xa, xa xoi, xa cach
removal	viec di chuyen, viec don nha, doi di
remove	doi di, di chuyen
rent	su thue muon; cho thue, thue
rented	duoc thue, duoc muon
repair	sua chua, chinh tu; su sua chua, su chinh tu
repeat	nhac lai, lap lai
repeated	duoc nhac lai, duoc lap lai
repeatedly	lap di lap lai nhieu lan
replace	thay the
reply	su tra loi, su hoi am; tra loi, hoi am
report	bao cao, tuong trinh; ban bao cao, ban tuong trinh
represent	mieu ta, hinh dung; dai dien, thay mat
representative	dieu tieu bieu, tuong trung, mau; mieu ta, bieu hien, dai dien, tuong trung
reproduce	tai san xuat
reputation	su noi tieng, noi danh
request	loi thinh cau, loi de nghi, yeu cau; thinh cau, de nghi, yeu cau
require	doi hoi, yeu cau, quy dinh
requirement	nhu cau, su doi hoi; luat le, thu tuc
rescue	giai thoat, cuu nguy; su giai thoat, su cuu nguy
research	su nghien cuu
reservation	su han che, dieu kien han che
reserve	du tru, de danh, dat truoc, dang ky truoc; su du tru, su de danh, su dat truoc, su dang ky truoc
resident	nguoi sinh song, tru ngu, khach tro; co nha o, cu tru, thuong tru
resist	chong lai, phan doi, khang cu
resistance	su chong lai, su phan doi, su khang cu
resolve	quyet dinh, kien quyet (lam gi); giai quyet (van de, kho kha(n).)
resort	ke sach, phuong ke
resource	tai nguyen; ke sach, thu doan
respect	su kinh trong, su le phep; ton trong, kinh trong, kham phuc
respond	huong ung, phan ung lai, tra loi
response	su tra loi, cau tra loi, su huong ung, su dap lai
responsibility	trach nhiem, su chiu trach nhiem
responsible	chiu trach nhiem ve, chiu trach nhiem truoc ai, gi
rest	su nghi ngoi, luc nghi; nghi, nghi ngoi. the rest vat, cai con lai, nhung nguoi, cai khac
restaurant	nha hang an, hieu an
restore	hoan lai, tra lai; sua chua lai, phuc hoi lai
restrict	han che, gioi han
restricted	bi han che, co gioi han; vung cam
restriction	su han che, su gioi han
result	ket qua; boi, do.. ma ra, ket qua la...
retain	giu lai, nho duoc
retire	roi bo, rut ve; thoi, nghi viec, ve huu
retired	an dat, heo lanh, da ve huu, da nghi viec
retirement	su an dat, noi heo lanh, su ve huu, su nghi viec
return	tro lai, tro ve; su tro lai, su tro ve
reveal	boc lo, bieu lo, tiet lo; phat hien, kham pha
reverse	dao, nguoc lai; dieu trai nguoc, mat trai
review	su xem lai, su xet lai; lam lai, xem xet lai
revise	doc lai, xem lai, sua lai, on lai
revision	su xem lai, su doc lai, su sua lai, su on lai
revolution	cuoc cach mang
reward	su thuong, phan thuong; thuong, thuong cong
rhythm	nhip dieu
rice	gao, thoc, com; cay lua
rich	giau, giau co
rid	giai thoat (get rid of : tong khu)
ride	di, cuoi (ngua); su di, duong di
rider	nguoi cuoi ngua, nguoi di xe dap
ridiculous	buon cuoi, lo bich, lo lang
riding	mon the thao cuoi ngua, su di xe (bus, dien, xe dap)
right	thang, phai, tot; ngay, dung; dieu thien, dieu phai, tot, ben phai
rightly	dung, phai, co ly
ring	chiec nhan, deo nhan cho ai
rise	su len, su tang luong, thang cap; day, dung len, moc (mat troi), thanh dat
risk	su lieu, mao hiem; lieu
rival	doi thu, dich thu; doi dich, canh tranh
river	song
road	con duong, duong pho
rob	cuop, lay trom
rock	da
role	vai (dien), vai tro
roll	cuon, cuon, su lan tron; lan, cuon, quan, cuon
romantic	lang man
roof	mai nha, noc
room	phong, buong
root	goc, re
rope	day cap, day thung, xau, chuoi
rough	go ghe, lom chom
roughly	go ghe, lom chom
round	tron, vong quanh, xung quanh
rounded	bi lam thanh tron; phat trien day du
route	duong di, lo trinh, tuyen duong
routine	thoi thuong, le thuong, thu tuc; thuong le, thong thuong
row	hang, day
royal	(thuoc) vua, nu hoang, hoang gia
rub	co xat, xoa bop, nghien, tan
rubber	cao su
rubbish	vat vo gia tri, bo di, rac ruoi
rude	bat lich su, tho lo; tho so, don gian
rudely	bat lich su, tho lo; tho so, don gian
ruin	lam hong, lam do nat, lam pha san; su hong, su do nat, su pha san
ruined	bi hong, bi do nat, bi pha san
rule	quy tac, dieu le, luat le; cai tri, chi huy, dieu khien
ruler	nguoi cai tri, nguoi tri vi; thuoc ke
rumour	tin don, loi don
run	chay; su chay
runner	nguoi chay
running	su chay, cuoc chay dua
rural	(thuoc) nong thon, vung nong thon
rush	xong len, lao vao, xo day; su xong len, su lao vao, su xo day
sack	bao tai; dong bao, bo vao bao
sad	buon, buon ba
sadly	mot cach buon ba, dang buon la, khong may ma
sadness	su buon rau, su buon ba
safe	an toan, chac chan, dang tin
safely	an toan, chac chan, dang tin
safety	su an toan, su chac chan
sail	di tau, thuyen, nho neo; buom, canh buom, chuyen di bang thuyen buom
sailing	su di thuyen
sailor	thuy thu
salad	sa lat (xa lach trong dau dam); rau song
salary	tien luong
sale	viec ban hang
salt	muoi
salty	chua vi muoi, co muoi, man
same	deu deu, don dieu; cung nhu the, van cai do
sample	mau, hang mau
sand	cat
satisfaction	su lam cho thoa man, toai nguyen su tra no, boi thuong
satisfied	cam thay hai long, vua y, thoa man
satisfy	lam thoa man, hai long; tra (no), chuoc toi
satisfying	dem lai su thoa man, lam thoa man, lam vua y
saturday	thu 7
sauce	nuoc xot, nuoc cham
save	cuu, luu
saving	su cuu, su tiet kiem
say	noi
scale	vay (ca..), ty le
scare	lam kinh hai, so hai, doa; su so hai, su kinh hoang
scared	bi hoang so, bi so hai
scene	canh, phong canh
schedule	ke hoach lam viec, ban liet ke; len thoi khoa bieu, len ke hoach
scheme	su sap xep, su phoi hop; ke hoach thuc hien; luoc do, so do
school	dan ca, bay ca, truong hoc, hoc duong
science	khoa hoc, khoa hoc tu nhien
scientific	(thuoc) khoa hoc, co tinh khoa hoc
scientist	nha khoa hoc
scissors	cai keo
score	diem so, ban thang, ty so; dat duoc, thanh cong, cho diem
scratch	cao, lam xuoc da; su cao, su tray xuoc da
scream	gao thet, keu len; tieng thet, tieng keu to
screen	man che, man anh, man hinh; phim anh noi chung
screw	dinh vit, dinh oc; bat vit, bat oc
sea	bien
seal	hai cau; san hai cau
search	su tim kiem, su tham do, su dieu tra; tim kiem, tham do, dieu tra
season	mua
seat	ghe, cho ngoi
second	thu hai, o vi tri thu 2, thu nhi; nguoi ve nhi
secondary	trung hoc, thu yeu
secret	bi mat; dieu bi mat
secretary	thu ky
secretly	bi mat, rieng tu
section	muc, phan
sector	khu vuc, linh vuc
secure	chac chan, dam bao; bao dam, giu an ninh
security	su an toan, su an ninh
see	nhin, nhin thay, quan sat
seed	hat, hat giong
seek	tim, tim kiem, theo duoi
select	chon lua, chon loc
selection	su lua chon, su choc loc
self	ban than minh
sell	ban
senate	thuong nghi vien, ban giam hieu
senator	thuong nghi si
send	gui, phai di
senior	nhieu tuoi hon, danh cho tre em tren 11t; nguoi lon tuoi hon, sinh vien nam cuoi truong trung hoc, cao dang
sense	giac quan, tri giac, cam giac
sensible	co oc xet doan; hieu, nhan biet duoc
sensitive	de bi thuong, de bi hong; de bi xuc pham
sentence	cau
separate	khac nhau, rieng biet; lam roi, tach ra, chia tay
separated	ly than
separately	khong cung nhau, thanh nguoi rieng, vat rieng
separation	su chia cat, phan ly, su chia tay, ly than
september	thang 9
series	loat, day, chuoi
serious	dung dan, nghiem trang
seriously	dung dan, nghiem trang
servant	nguoi hau, day to
serve	phuc vu, phung su
service	su phuc vu, su hau ha
session	buoi hop, phien hop, buoi, phien
set	bo, bon, dam, lu; dat de, bo tri
settle	giai quyet, dan xep, hoa giai, dat, bo tri
several	vai
severe	khat khe, gay gat (thai do, cu xu); gian di, moc mac (kieu cach, trang phuc, dung nhan)
severely	khat khe, gay gat (thai do, cu xu); gian di, moc mac (kieu cach, trang phuc, dung nhan)
sew	may, khau
sewing	su khau, su may va
sex	gioi, giong
sexual	gioi tinh, cac van de sinh ly
sexually	gioi tinh, cac van de sinh ly
shade	bong, bong toi
shadow	bong, bong toi, bong ram, bong mat
shake	rung, lac, giu; su rung, su lac, su giu
shall	du doan tuong lai: se
shallow	nong, can
shame	su xau ho, then thung, su nguong
shape	hinh, hinh dang, hinh thu
shaped	co hinh dang duoc chi ro
share	dong gop, tham gia, chia se; phan dong gop, phan tham gia, phan chia se
sharp	sac, nhon, ben
sharply	sac, nhon, ben
shave	cao (rau), bao, deo (go)
she	no, ba ay, chi ay, co ay...
sheep	con cuu
sheet	chan, khan trai giuong; la, tam, phien, to
shelf	ke, ngan, gia
shell	vo, mai; ve be ngoai
shelter	su nuong tua, su che cho, su an nau; che cho, bao ve
shift	doi cho, doi cho, chuyen, giao; su thay doi, su luan phien
shine	chieu sang, toa sang
shiny	sang choi, bong
ship	tau, tau thuy
shirt	ao so mi
shock	su dung cham, va cham, su kich dong, su choang; cham manh, va manh, gay soc
shocked	bi kich dong, bi va cham, bi soc
shocking	gay ra cam phan, toi te, gay kich dong
shoe	giay
shoot	vut qua, chay qua, nem, phong, ban; dam ra, troi ra
shooting	su ban, su phong di
shop	cua hang; di mua hang, di cho
shopping	su mua sam
short	ngan, cut
shortly	trong thoi gian ngan, som
shot	dan, vien dan
should	nen
shoulder	vai
shout	ho het, reo ho; su la het, su ho reo
show	bieu dien, trung bay; su bieu dien su bay to
shower	voi hoa sen, su tam voi hoa sen
shut	dong, khep, day; tinh khep kin
shy	nhut nhat, e then
sick	om, dau, benh
side	mat, mat phang, cho, vi tri
sideways	ngang, tu mot ben; sang ben
sight	canh dep; su nhin
sign	dau, dau hieu, ki hieu; danh dau, viet ky hieu
signal	dau hieu, tin hieu; ra hieu, bao hieu
signature	chu ky
significant	nhieu y nghia, quan trong
significantly	dang ke
silence	su im lang, su yen tinh
silent	im lang, yen tinh
silk	to, chi, lua
silly	ngo ngan, ngu ngoc, kho dai
silver	bac, dong bac; lam bang bac, trang nhu bac
similar	giong nhu, tuong tu nhu
similarly	tuong tu, giong nhau
simple	don, don gian, de dang
simply	mot cach de dang, gian di
since	tu, tu khi, tu luc do; tu do, tu luc ay
sincere	that tha, thang thang, chan thanh
sincerely	mot cach chan thanh
sing	hat, ca hat
singer	ca si
singing	su hat, tieng hat
single	don, don doc, don le
sink	chim, lun, dam
sir	xung ho lich su ngai, ong
sister	chi, em gai
sit	ngoi. sit down: ngoi xuong
situation	hoan canh, dia the, vi tri
size	co. da duoc dinh co
skilful	tai gioi, kheo tay
skilfully	tai gioi, kheo tay
skill	ky nang, ky sao
skilled	co ky nang, co ky sao, kheo tay; co kinh nghiem,, lanh nghe
skin	da, vo
skirt	vay, dam
sky	troi, bau troi
sleep	ngu; giac ngu
sleeve	tay ao, ong tay
slice	mieng, lat mong; cat ra thanh mieng mong, lat mong
slide	truotc, chuyen dong nhe, luot qua
slight	mong manh, thon, gay
slightly	manh khanh, mong manh, yeu ot
slip	truot, tuot, troi qua, chay qua
slope	doc, duong doc, do doc; nghieng, doc
slow	cham, cham chap
slowly	mot cach cham chap, cham dan
small	nho, be
smart	manh, ac liet, kheo leo, khon kheo
smash	dap, vo tan thanh manh; su dap, vo tan thanh manh
smell	ngui; su ngui, khuu giac
smile	cuoi, mim cuoi; nu cuoi, ve tuoi cuoi
smoke	khoi, hoi thuoc; hut thuoc, boc khoi, hoi
smoking	su hut thuoc
smooth	nhan, tron, muot ma
smoothly	mot cach em a, troi chay
snake	con ran; nguoi nham hiem, xao tra
snow	tuyet; tuyet roi
so	nhu vay, nhu the; vi the, vi vay, vi the cho nen so that de, de cho, de ma
soap	xa phong
social	co tinh xa hoi
socially	co tinh xa hoi
society	xa hoi
sock	tat ngan, mieng lot giay
soft	mem, deo
softly	mot cach mem deo
software	phan mem (m.tinh)
soil	dat trong; vet ban
soldier	linh, quan nhan
solid	ran; the ran, chat ran
solution	su giai quyet, giai phap
solve	giai, giai thich, giai quyet
some	mot it, mot vai
somebody	nguoi nao do
somehow	khong biet lam sao, bang cach nay hay cach khac
something	mot dieu gi do, mot viec gi do, mo cai gi do
spend	tieu, xai
spice	gia vi
spicy	co gia vi
spider	con nhen
spin	quay, quay tron
spirit	tinh than, tam hon, linh hon
spiritual	(thuoc) tinh than, linh hon
spite	su gian, su han thu; in spite of: mac du, bat chap
split	che, tach, chia ra; su che, su tach su chia ra
spoil	cuop, cuop doat
spoken	noi theo 1 cach nao do
spoon	cai thia
sport	the thao
spot	dau, dom, vet
spray	may, ong, binh phut, bom, phun; bom, phun, xit
spread	trai, cang ra, bay ra; truyen ba
spring	mua xuan
square	vuong, vuong van; dang hinh vuong, hinh vuong
squeeze	ep, vat, xiet; su ep, su vat, su xiet
stable	on dinh, binh tinh, vung vang; chuong ngua
staff	gay
stage	tang, be, san khau, giai doan
stair	bac thang
stamp	tem; dan tem
stand	dung, su dung. stand up: dung day
standard	tieu chuan, chuan, mau; lam tieu chuan, phu hop voi tieu chuan
star	ngoi sao, dan sao, trang tri hinh sao, danh dau sao
stare	nhim cham cham; su nhin cham cham
start	bat dau, khoi dong; su bat dau, su khoi dau, khoi hanh
state	nha nuoc, quoc gia, chinh quyen; (thuoc) nha nuoc, co lien quan den nha nuoc; phat bieu, tuyen bo
statement	su bay to, su phat bieu; su tuyen bo, su trinh bay
station	tram, diem, don
statue	tuong
status	tinh trang
stay	o lai, luu lai; su o lai, su luu lai
steadily	vung chac, vung vang, kien dinh
steady	vung chac, vung vang, kien dinh
steal	an cap, an trom
steam	hoi nuoc
steel	thep, nganh thep
steep	doc, doc dung
steeply	doc, cheo leo
steer	lai (tau, o to...)
step	buoc; buoc, buoc di
stick	dam, thoc, choc, cam, dinh; cai gay, qua cui, can
sticky	dinh; sanh; bay nhay, nhop nhap
stiff	cung, cung ran, kien quyet
stiffly	cung, cung ran, kien quyet
still	dung yen; van, van con
sting	cham, chich, dot; ngoi, voi (ong, muoi), noc (ran); su cham, chich..
stir	khuay, dao
stock	kho su tru, hang du tru, von
stomach	da day
stone	da
stop	dung, ngung, nghi, thoi; su dung, su ngung, su do lai
store	cua hang, kho hang; tich tru, cho vao kho
storm	con giong, b~o
story	chuyen, cau chuyen
stove	bep lo, lo suoi
straight	thang, khong cong
strain	su cang thang, su cang
strange	xa la, chua quen
strangely	la, xa la, chua quen
stranger	nguoi la
strategy	chien luoc
stream	dong suoi
strength	suc manh, suc khoe
stress	su cang thang; cang thang, ep, lam cang
stressed	bi cang thang, bi ep, bi cang
stretch	cang ra, duoi ra, keo dai ra
strict	nghiem khac, chat che,, khat khe
strictly	mot cach nghiem khac
strike	danh, dap, bai cong, dinh cong; cuoc bai cong, cuoc dinh cong
striking	noi bat, gay an tuong
string	day, soi day
strip	coi, lot (quan ao); su coi quan ao
stripe	soc, van, vien
striped	co soc, co van
stroke	cu danh, cu don; cai vuot ve, su vuot ve; vuot ve
strong	khoe, manh, ben, vung, chac chan
strongly	khoe, chac chan
structure	ket cau, cau truc
struggle	dau tranh; cuoc dau tranh, cuoc chien dau
student	sinh vien
studio	xuong phim, truong quay; phong thu
study	su hoc tap, su nghien cuu; hoc tap, nghien cuu
stuff	chat lieu, chat
stupid	ngu ngoc, ngu dan, ngo ngan
style	phong cach, kieu, mau, loai
subject	chu de, de tai; chu ngu
substance	chat lieu; ban chat; noi dung
substantial	thuc te, dang ke, quan trong
substantially	ve thuc chat, ve can ban
substitute	nguoi, vat thay the; thay the
succeed	noi tiep, ke tiep; ke nghiep, ke vi
success	su thanh cong, su thanh dat
successful	thanh cong, thang loi, thanh dat
successfully	thanh cong, thang loi, thanh dat
such	nhu the, nhu vay, nhu la. such as den noi, den muc
suck	bu, hut; hap thu, tiep thu
sudden	thinh linh, dot ngot
suddenly	thinh linh, dot ngot
street	pho, duong pho
suffer	chiu dung, chiu thiet hai, dau kho
suffering	su dau don, su dau kho
sufficient	(+ for) du, thich dang
sufficiently	du, thich dang
sugar	duong
suggest	de nghi, de xuat; goi
suggestion	su de nghi, su de xuat, su kheu goi
suit	bo com le, trang phuc; thich hop, quen, hop voi
suitable	hop, phu hop, thich hop voi
suitcase	va li
suited	hop, phu hop, thich hop voi
sum	tong, toan bo
summary	ban tom tat
summer	mua he
sun	mat troi
sunday	chu nhat
superior	cao, chat luong cao
supermarket	sieu thi
supply	su cung cap, nguon cung cap; cung cap, dap ung, tiep te
support	su chong do, su ung ho; chong do, ung ho
supporter	vat chong do; nguoi co vu, nguoi ung ho
suppose	cho rang, tin rang, nghi rang
sure	chac chan, xac thuc. make sure chac chan, lam cho chac chan
surely	chac chan
surface	mat, be mat
surname	ho
surprise	su ngac nhien, su bat ngo; lam ngac nhien, gay bat ngo
surprised	ngac nhien (+ at)
surprising	lam ngac nhien, lam bat ngo
surprisingly	lam ngac nhien, lam bat ngo
surround	vay quanh, bao quanh
surrounding	su vay quanh, su bao quanh
surroundings	vung xung quanh, moi truong xung quanh
survey	su nhin chung, su khao sat; quan sat, nhin chung, khao sat, nghien cuu
survive	song lau hon, tiep tuc song, song sot
suspect	nghi ngo, hoai nghi; nguoi kha nghi, nguoi bi tinh nghi
suspicion	su nghi ngo, su ngo vuc
suspicious	co su nghi ngo, to ra nghi ngo, kha nghi
swallow	nuot, nuot chung
swear	chui rua, nguyen rua; the, hua
swearing	loi the, loi nguyen rua, loi the hua
sweat	mo hoi; do mo hoi
sweater	nguoi ra mo hoi,, ke boc lot lao dong
sweep	quet
sweet	ngot, co vi ngot; su ngot bui, do ngot
swell	phong, sung len
swelling	su sung len, su phong ra
swim	boi loi
swimming	su boi loi
swimming pool	be nuoc
swing	su du dua, luc lac; danh du, du dua, luc lac
switch	cong tac, roi; tat, bat, danh bang gay, roi. switch sth off ngat dien. switch sth on bat dien
swollen	sung phong, phinh cang
symbol	bieu tuong, ky hieu
sympathetic	dong cam, dang men, de thuong
sympathy	su dong cam, su dong y
system	he thong, che do
table	cai ban
tablet	tam, ban, the phien
tackle	giai quyet, khac phuc, ban thao; do dung, dung cu
tail	duoi, doan cuoi
take	su cam nam, su lay. take sth off: coi, bo cai gi, lay di cai gi
talk	noi chuyen, tro chuyen; cuoc tro chuyen, cuoc thao luan
tall	cao
tank	thung, ket, be
tap	mo voi, dong voi; voi, khoa
tape	bang, bang ghi am; dai, day
target	bia, muc tieu, dich
task	nhiem vu, nghia vu, bai tap, cong tac, cong viec
taste	vi, vi giac; nem
tax	thue; danh thue
taxi	xe tac xi
tea	cay che, tra, che
teach	day
teacher	giao vien
teaching	su day, cong viec day hoc
team	doi, nhom
tear	xe, lam rach; cho rach, mieng xe; nuoc mat
technical	(thuoc) ky thuat, chuyen mon
technique	ky sao, ky thuat, phuong phap ky thuat
technology	ky thuat hoc, cong nghe hoc
telephone	may dien thoai, goi dien thoai
television	vo tuyen truyen hinh
tell	noi, noi voi
temperature	nhiet do
temporarily	tam
temporary	tam thoi, nhat thoi
tend	trong nom, cham soc, giu gin, hau ha
tendency	xu huong, chieu huong, khuynh huong
tension	su cang, do cang, tinh trang cang
tent	leu, rap
term	gioi han, ky han, khoa, ky hoc
terrible	khung khiep, ghe so
terribly	toi te, khong chiu noi
test	bai kiem tra, su thu nghiem, xet nghiem; kiem tra, xet nghiem, thu nghiem
text	nguyen van, ban van, chu de, de
than	hon
thank	cam on
thank you	cam on ban (ong ba, anh chi...)
thanks	su cam on, loi cam on
that	nguoi ay, do, vat ay, do; rang, la
the	cai, con, nguoi, ay nay....
theatre	rap hat, nha hat
their	cua chung, cua chung no, cua ho
theirs	cua chung, cua chung no, cua ho
them	chung, chung no, ho
theme	de tai, chu de
themselves	tu chung, tu ho, tu
then	khi do, luc do, tiep do
theory	ly thuyet, hoc thuyet
there	o noi do, tai noi do
therefore	boi vay, cho nen, vi the
they	chung, chung no, ho; nhung cai ay
thick	day; dam
thickly	day; day dac; thanh lop day
thickness	tinh chat day, do day, be day
thief	ke trom, ke cap
thin	mong, manh
thing	cai, do, vat
think	nghi, suy nghi
thinking	su suy nghi, y nghi
thirsty	khat, cam thay khat
this	cai nay, dieu nay, viec nay
thorough	can than, ky luong
thoroughly	ky luong, thau dao, triet de
though	du, du cho, mac du; mac du, tuy >nhien, tuy vay
thought	su suy nghi, kha >nang suy nghi; y >nghi, tu tuong, tu duy
thread	chi, soi chi, soi day
threat	su de doa, loi de doa
threaten	doa, de doa
threatening	su de doa, su ham doa
throat	co, co hong
through	qua, xuyen qua
throughout	khap, suot
throw	nem, vut, quang. throw sth away: >nem di, vut di, lieng di
thumb	ngon tay cai
thursday	thu 5
thus	nhu vay, nhu the, do do
ticket	ve
tidy	sach se, ngan nap, gon gang; lam >cho sach se, gon gang, ngan nap
tie	buoc, cot, troi; day buoc, day troi, >day giay. tie sth up co quan he >mat >thiet, gan chat
tight	kin, chat, chat
tightly	chat che, sit sao
till	cho den khi, toi luc ma
time	thoi gian, thi gio
timetable	ke hoach lam viec, thoi gian bieu
tin	thiec
tiny	rat nho, nho xiu
tip	dau, mut, dinh, chop; bit dau, lap >dau vao
tire	lam met moi, tro nen met nhoc; >lop, vo xe
tired	met, muon ngu, nham chan
tiring	su met moi, su met nhoc
title	dau de, tieu de; tuoc vi, tu cach
to	theo huong, toi
today	vao ngay nay; hom nay, ngay nay
toe	ngon chan (nguoi)
together	cung nhau, cung voi
toilet	nha ve sinh; su trang diem (rua >mat, an mac, chai toc...)
tomato	ca chua
tomorrow	vao ngay mai; ngay mai
ton	tan
tone	tieng, giong
tongue	luoi
tonight	vao dem nay, vao toi nay; dem >nay, toi nay
tonne	tan
too	cung
tool	dung cu, do dung
tooth	rang
top	chop, dinh; dung dau, tren het
topic	de tai, chu de
total	tong cong, toan bo; tong so, toan >bo so luong
totally	hoan toan
touch	so, mo, tiep xuc; su so, su mo, su >tiep xuc
tough	chac, ben, dai
tour	cuoc do du lich, cuoc di dao, >chuyen du lich; di du lich
tourist	khach du lich
towards	theo huong, ve huong
towel	khan tam, khan lau
tower	thap
town	thi tran, thi xa, thanh pho nho
toy	do choi, do trang tri; the loai do >choi
trace	phat hien, tim thay, vach, chi ra, >phac hoa; dau, vet, mot chut
track	phan cua dia; duong mon, duong >dua
trade	thuong mai, buon ban; buon ban, >trao doi
trading	su kinh >doanh, viec mua ban
tradition	truyen thong
traditional	theo truyen thong, theo loi co
traditionally	(thuoc) truyen thong, la truyen >thong
traffic	su di lai, su giao thong, su >chuyen >dong
train	xe lua, tau hoa; day, ren luyen, >dao tao
training	su day do, su huan luyen, su dao >tao
transfer	doi, di chuyen; su di chuyen, su >doi cho
transform	thay doi, bien doi
translate	dich, bien dich, phien dich
translation	su dich
transparent	trong suot; de hieu, sang sua
transport	su van chuyen, su van tai; >phuong tien di lai
trap	do dac, hanh ly; bay, cam bay; >bay, giu, chan lai
travel	di lai, di du lich, di chuyen; su di, >nhung chuyen di
traveller	nguoi di, lu khach
treat	doi xu, doi dai, cu xu
treatment	su doi xu, >su cu xu
tree	cay
trend	phuong huong, xu huong, chieu >huong
trial	su thu nghiem, cuoc thu nghiem
triangle	hinh tam giac
trick	muu meo, thu doan, tro lua gat, >lua gat
trip	cuoc dao choi, cuoc du ngoan; di >dao, du ngoan
tropical	nhiet doi
trouble	dieu lo lang, dieu muon phien
trousers	quan tay
truck	su trao doi, su doi chac
true	dung, that
truly	dung su that, dich thuc, thuc su
trust	niem tin, su pho thac; tin, tin cay, pho thac
truth	su that
try	thu, co gang
tube	ong, tuyp
tuesday	thu 3
tune	dieu, giai dieu; len day, so day (dan)
tunnel	duong ham, hang
turn	quay, xoay, van; su quay, vong quay
twice	hai lan
twin	sinh doi, tao thanh cap; cap song sinh
twist	xoan, cuon, quan; su xoan, vong xoan
twisted	duoc xoan, duoc cuon
type	loai, kieu, mau; phan loai, xep loai
typical	tieu bieu, dien hinh, dac trung
typically	dien hinh, tieu bieu
tyre	lop, vo xe
ugly	xau xi, xau xa
ultimate	cuoi cung, sau cung
ultimately	cuoi cung, sau cung
umbrella	o, du
unable	khong co nang luc, khong co tai, khong the, khong co kha nang
unacceptable	khong chap nhan duoc
uncertain	thieu chinh xac, khong chac chan
uncle	chu, bac
uncomfortable	bat tien, kho chiu, khong thoai ma
unconscious	bat tinh, khong co y thuc, khong biet ro
uncontrolled	khong bi dieu khien, khong bi kiem tra, khong bi han che
under	duoi, o duoi; o phia duoi, ve phia duoi
underground	duoi mat dat, ngam duoi dat; ngam
underneath	duoi, ben duoi
understand	hieu, nhan thuc
understanding	tri tue, su hieu biet
underwater	o duoi mat nuoc, duoi mat nuoc
underwear	quan lot
undo	thao, go; xoa bo, huy bo
unemployed	that nghiep; khong dung, khong su dung duoc
unemployment	su that nghiep, nan that nghiep
unexpected	bat ngo, gay ngac nhien
unexpectedly	bat ngo, gay ngac nhien
unfair	gian lan, khong cong bang; bat loi
unfairly	gian lan, khong cong bang; bat loi
unfortunate	khong may, rui ro, bat hanh
unfortunately	mot cach dang tiec, mot cach khong may
unfriendly	khong than thien, khong co thien cam
unhappiness	noi buon, su bat hanh
unhappy	buon rau, khon kho
uniform	dong phuc; deu, giong nhau, dong dang
unimportant	khonh quan trong, khong trong da
union	lien hiep, su doan ket, su hiep nhat
unique	doc nhat vo nhi
unit	don vi
unite	lien ket, hop nhat, hop lai, ket than
united	lien minh, doan ket, chung, thong nhat
universe	vu tru
university	truong dai hoc
unkind	doc ac, tan nhan
unknown	khong biet
unless	tru phi, tru khi, neu khong
unlike	khac, khong giong
unlikely	khong the xay ra, khong chac xay ra
unload	cat ganh nang, do hang
unlucky	khong gap may, bat hanh
unnecessary	khong can thiet, khong mong muon
unpleasant	khong de chiu, kho chiu, kho ua
unreasonable	vo ly
unsteady	khong chac, khong on dinh
unsuccessful	khong thanh cong, that bai
untidy	khong gon gang, khong ngan nap, lon xon
until	truoc khi, cho den khi
unusual	hiem, khac thuong
unusually	cuc ky, khac thuong
unwilling	khong muon, khong co y dinh
unwillingly	khong san long, mien cuong
up	o tren, len tren, len
upon	tren, o tren
upper	cao hon
upset	lam do, danh do
upsetting	tinh danh do, lam do
upside down	lon nguoc
upstairs	o ten gac, cu ngu o tang gac; tang tren, gac
upward	len, huong len, di len
upwards	len, huong len, di len, ve phia tren
urban	(thuoc) thanh pho, khu vuc
urge	thuc, giuc, giuc gia; su thuc day, su thoi thuc
urgent	gap, khan cap
us	chung toi, chung ta; toi va anh
use	su dung, dung; su dung, su su dung
used	da dung, da su dung. used to sth/to doing sth: su dung cai gi, su dung de lam cai gi
useful	huu ich, giup ich
useless	vo ich, vo dung
user	nguoi dung, nguoi su dung
usual	thong thuong, thuong dung
usually	thuong thuong
vacation	ky nghi he, ky nghi le; ngay nghi, ngay le
valid	chac chan, hieu qua, hop ly
valley	thung lung
valuable	co gia tri lon, dang gia
value	gia tri, uoc tinh, dinh gia
van	tien doi, quan tien phong, xe tai
variation	su bien doi, su thay doi muc do, su khac nhau
varied	thuoc nhieu loai khac nhau, nhung ve da dang
variety	su da dang, trang thai khac nhau
various	khac nhau, thuoc ve nhieu loai
vary	thay doi, lam cho khac nhau, bien doi
vast	rong lon, menh mong
vegetable	rau, thuc vat
vehicle	xe co
venture	du an kinh doanh, cong viec kinh doanh; lieu, mao hiem, ca gan
version	ban dich sang mot ngon ngu khac
vertical	thang dung, dung
very	rat, lam
via	qua, theo duong
victim	nan nhan
victory	chien thang
video	video
view	su nhin, tam nhin; nhin thay, xem, quan sat
village	lang, xa
violence	su ac liet, su du doi; bao luc
violent	manh liet, manh me, hung du
violently	manh liet, du doi
virtually	thuc su, hau nhu, gan nhu
virus	vi rut
visible	huu hinh, thay duoc
vision	su nhin, thi luc
visit	di tham hoi, den choi, tham quan; su di tham, su tham vieng
visitor	khach, du khach
vital	(thuoc) su song, can cho su song
vocabulary	tu vung
voice	tieng, giong noi
volume	the tich, quyen, tap
vote	su bo phieu, su bau cu; bo phieu, bau cu
wage	tien luong, tien cong
waist	eo, cho that lung
wait	cho doi
waiter	nguoi hau ban, nguoi doi, nguoi trong cho
waitress	nu hau ban
wake	thuc day, tinh thuc
walk	di, di bo; su di bo, su di dao
walking	su di, su di bo
wall	tuong, vach
wallet	cai vi
wander	di lang thang; su di lang thang
want	muon
war	chien tranh
warm	am, am ap; lam cho nong, ham nong
warmth	trang thai am, su am ap; hoi am
warn	bao cho biet, canh bao
warning	su bao truoc, loi canh bao
wash	rua, giat
washing	su tam rua, su giat
waste	lang phi, uong phi; vung hoang vu sa mac; bo hoang
watch	nhin, theo doi, quan sat; su canh gac, su canh phong
water	nuoc
wave	song, gon nuoc; gon song, uon thanh song
way	duong, duong di
we	chung toi, chung ta
weak	yeu, yeu ot
weakness	tinh trang yeu duoi, yeu ot
wealth	su giau co, su giau sang
weapon	vu khi
wear	mac, mang, deo
weather	thoi tiet
web	mang, luoi
website	khong gian lien toi voi internet
wedding	le cuoi, hon le
wednesday	thu 4
week	tuan, tuan le
weekend	cuoi tuan
weekly	moi tuan mot lan, hang tuan
weigh	can, can nang
weight	trong luong
welcome	chao mung, hoan nghenh
well	tot, gioi; oi, may qua!
well known	noi tieng, duoc nhieu nguoi biet den
west	phia tay, theo phia tay, ve huong tay
western	ve phia tay, cua phia tay
wet	uot, am uot
what	gi, the nao
whatever	bat cu thu gi, bat ke thu gi
wheel	banh xe
when	khi, luc, vao luc nao
whenever	bat cu luc nao, luc nao
where	dau, o dau; noi 